Which French monarch reinstated the divine right of the monarchy to France and was known as `The Sun King' because of the splendour of his reign? 	PERSON
The `Wicked Bible', printed in 1631, became so called because the word `not' was omitted from which of the Ten Commandments? 	AMOUNT
Which eponymous hero of a work first published in 1902 was warned of the dangers lurking in a nearby garden with the words `Your father had an accident there; he was put in a pie by Mr. McGregor'? 	PERSON
Which European patron saint was once a ruler of Bohemia and has given his name to a Square in Prague? 	PERSON
Which Italian term describes a virtuoso passage, usually for a solo instrument near the end of a concerto, originally intended to have an improvisatory character. 	OTHER
Which boxer, representing Canada, won the 1988 Olympic Super-Heavyweight Gold Medal, defeating Riddick Bowe of the USA in the final? 	PERSON
Which competition was won by Eimear Quinn with `The Voice' in 1996, this being the fourth win in five years for her country? 	OTHER
Which battle, whose 250th anniversary was celebrated in April 1996, was fought on a part of Drummossie Muir whose name translates from the Gaelic as `stinking bog'? 	OTHER
Which fibre is produced from two species of of Corchorus plant, was first exported to the west from India in in the 1790s and from 1822 was manufactured commercially into yarn in Dundee? 	OTHER
Which Jane Austen heroine was told by her father, ``Your mother will never see you again if you do not marry Mr. Collins, and I will never see you again if you do.''? 	PERSON
Strenuous exercise can cause a build-up of which acid in the muscles. 	OTHER
Which commission was established in 1948 but adopted its present name in 1973 under the Fair Trading Act and has embraced the Competition Act since 1980? 	ORGANIZATION
Which performing arts complex was opened was opened in 1973 and was reported by National Geographic magazine as having had its roofline variously described as clam shells, full blown sails or a huddle of nuns in a high wind? 	OTHER
In chemistry, which organic compounds are characterised by the functional group COOH? 	OTHER
Which British physicist, whose four equations form a complete description of the inter-relation of electric and magnetic fields, gave his name to the c.g.s. unit of magnetic flux? 	PERSON
Who became Governor of Hong Kong after he lost his position as MP for Bath in the 1992 General Election? 	PERSON
From 1955 to 1957, the English soldier and field marshall Sir John Harding was Governor-General of which island during the terrorist campaign against its British administration? 	LOCATION
What name is given to the popular Greek spirit flavoured with aniseed? 	OTHER
In AD 324, which Roman emperor claimed Byzantium as a new Rome for the Eastern empire? 	PERSON
The first Violin Concerto in G minor by which composer, born in Cologne in 1838, has been voted Britain's favourite piece of classical music in each of the last three years when Classic FM has compiled a `Hall of Fame' from its listeners' votes? 	PERSON
Which seven word phrase originated in the United States as the title of a 1936 book on business psychology by Dale Carnegie? 	TITLE
Cecil Day Lewis' character Nigel Strangeways, whom he created in the detective novels which he wrote under the pseudonym Nicholas Blake, is widely believed to be based on which poet friend of the author? 	PERSON
The Russian modern pentathlete Boris Onischenko was disqualified from the 1976 Olympics for cheating in which of the five disciplines? 	OTHER
Which Sheffield-born pop star was described in `Select' magazine as having `The wit of Alan Bennett in the body of Kenneth Williams'? 	PERSON
In September 1995, France exploded a test nuclear weapon approximately 700 miles south-east of Tahiti at which atoll in the South Pacific? 	LOCATION
The Kalahari Desert covers part of Namibia, Zimbabwe and South Africa, but lies primarily within which land-locked country? 	LOCATION
What number results from adding the number of Noble Truths of Buddhism to the number of Pillars of Islam? 	AMOUNT
Charles II, also known as Charles the Mad, reigned in Spain from 1665 until 1700 and was the last Spanish monarch of which dynasty? 	OTHER
Which architect of the 19th century Gothic Revival was born in 1812 and is probably best known for his work, with Charles Barry,x on the Houses of Parliament?	PERSON
Which novelist, winner of the 1965 Nobel Prize for Literature, wrote "The Silent Don", published in two parts as "And Quiet Flows the Don" and "The Don Flows Home to the Sea"? 	PERSON
Which poet was born in 1572 and appointed Dean of St. Paul's Cathedral in 1621? 	PERSON
What name is given to goods sold not primarily to make a profit but to attract customers so that they might buy other goods? 	OTHER
Which creature is related to the sloth and the anteater, is found primarily in South America, and can be three, six and nine banded? 	OTHER
In which city did Hitler and his supporters invade the Burgerbraukeller to stage the abortive Beer Hall Putsch of November 1923? 	LOCATION
Which symphonic piece by Saint-Saens is based on a poem by Henri Cazalis, in which the fiddler Death summons skeletons from their graves at midnight? 	TITLE
The shoreline of the Caspian Sea lies on states of the former Soviet Union and which other country? 	LOCATION
Which pope, a member of the Medici family, excommunicated Martin Luther and appointed Henry VIII Defender of the Faith in England? 	PERSON
People with the hereditary disease sickle cell anaemia, particularly distributed among the black population of all continents, are resistant to which disease? 	OTHER
In electronics, what term is used for the range of frequencies within which the performance of a circuit or amplifier does not fall below a specified amount? 	OTHER
`I met a traveller from an antique land' is the opening line of which poem by Percy Bysshe Shelley? 	TITLE
Which Australian, nicknamed the Roehampton Rocket, achieved the unique feat of winning lawn tennis's grand slam twice, once as an amateur and once as a professional? 	PERSON
Which film, released in 1995 and taking it's title from a phrase used by Claude Rains' character in the 1941 film Casablanca, starred Kevin Spacey and Gabriel Byrne? 	TITLE
Between 1948 and 1957 John Costello was twice Taoiseach, or Prime Minister of the Irish Republic, but who was the Taoiseach before and after Costello and between his two terms? 	PERSON
`And the Lord spake unto Moses in the wilderness of Sinai' are the opening words (in the Authorised Version) of which book of the Old Testament? 	TITLE
In the United Kingdom, land identified as having flora and fauna, or geological or physiological features, needing protection may be designated as a SSSI. What do these initials represent? 	DEFINITION
Which king was supposedly described by Henry IV of France as `the wisest fool in Christendom'? 	PERSON
Which illuminated book of the gospels, considered a masterpiece of the Hiberno-Saxon style, can be found in the library of Trinity College, Dublin? 	TITLE
Based on the author's early experiences, which novel by Jack London recounts the Alaskan adventures of Jack Thornton and his dog Buck? 	TITLE
Which writer was appointed Professor of American Studies at the University of East Anglia in 1970? 	PERSON
Also known as the Norway lobster or the Dublin Bay prawn, by what name is Nephrops Norvegicus known when sold in food shops and restaurants? 	OTHER
First established by Fanny Waterman and Marion Harewood in 1963, an international piano competition has been held every three years in which English city? 	LOCATION
What was the name of the USA's planned system of combating incoming nuclear missiles which was represented by the initials SDI? 	DEFINITION
What name is commonly given to the type of fly whose scientific name is Musca Vomitoria, sometimes known as the blow fly? 	OTHER
Which British mathematician, who in 1854 published `Investigations of the Laws of Thought' is, with Augustus De Morgan, considered to be one of the founding fathers of mathematical logic? 	PERSON
Which colonel in the late seventeenth century posed as a clergyman in order to enter the Tower of London to steal the crown jewels? 	PERSON
If you flew due south from Aberdeen, what would be the last English county that you would fly over before encountering the English Channel? 	LOCATION
Whose law states that the rate of diffusion of a gas is inversely proportional to the square root of its density? 	PERSON
Which fictional character, who combined the roles of gentleman burglar and England cricketer, was created by E. W. Hornung and has been played on screen by Ronald Coleman and David Niven? 	PERSON
Which thriller series became in 1946 the first daily radio serial broadcast by the BBC, and use `The Devils Gallop' by Charles Williams as its signature tune?	TITLE
Which village in Galilee was the venue of the marriage at which Christ, agreeing to replenish the dwindling supply of festive drinks, turned water into wine? 	LOCATION
Will Hutton, author of the book ``The State We're In'', was appointed Editor of which Sunday broadcast newspaper in March 1996? 	OTHER
In which game is a goal scored when the ball passes between the central posts, and a behind scored when it passes between the central posts and a behind post? 	OTHER
In Dostoevsky's novel ``Crime and Punishment'', what is the name of the impoverished student who kills an old pawnbroker for her money? 	PERSON
The inscription on the tomb of which king in Westminster Abbey includes the words `Malleus Scotorum hic est', meaning `Here is the Hammer of the Scots'? 	PERSON
Which overture by Brahms, first performed at Breslau in 1881, makes use of four German studen songs including `Gaudeamus Igitur'? 	TITLE
Which ancient track follows the southern slope of the North Downs via Winchester and Canterbury to the Kent coast? 	LOCATION
What, according to Shakespeare's Macbeth, `knits up the ravelled sleeves of care'? 	OTHER
Glyceryl trinitrate belongs to a group of vasodilator drugs used to relieve which condition, linked mainly to diseases of the coronary arteries? 	OTHER
The physical constant usually denoted by k and having the value 1.38 * 10^-23 Joules per Kelvin, is named after which Austrian born physicist? 	PERSON
The Learmont report into the escape of prisoners from which jail led to the dismissal of Derek Lewis as Director-General of the Prison Service in 1995? 	OTHER
Which Florentine building, the work of the architect Giorgio Vasari, was originally constructed to hold the offices of the government judiciary? 	OTHER
What three word name is given to the family of joints which has been used in furniture making for centuries and which is identified by its tongue and mouth components? 	OTHER
Fought in Moravia on 2 December 1805, the Battle of the Three Emperors is otherwise known by which name? 	OTHER
Widely used in car trim, which metal when added to steel forms protective oxde film on the surface of the steel? 	OTHER
Which 1990 film, directed by Tim Burton and described as a modern fairy tale was advertised with the words ``His story will touch you, even though he can't''?	TITLE
In the stories by James Herriot, what surname does he use for the brothers Siegfried and Tristan, the brothers whose vetinary practice he shares? 	OTHER
Which country, with and area greater than the combined areas of France, Germany and Italy, was part of the vice-royalty of New Spain, established in 1535 until it achieved independence in 1821? 	LOCATION
What name is given to the syrup which remains after sugar has been crystallized out of cane and from which rum is made? 	OTHER
Which organization was born out of the the so-called Limehouse Declaration in 1981? 	ORGANIZATION
The Book of Changes, an ancient book of divination and one of the five classics of Confucianism, is known by which Chinese name? 	TITLE
The ``Pilgrim's Chorus'' came from which Wagner opera about a minstrel knight of the thirteenth century? 	TITLE
In the third century BC, which Carthagian general led his forcres to victory over the Romans at locations including the Ticinus River, the Trebia Plain and the shores of Lake Trasimene? 	PERSON
In which event in the 1908 London Olympics was Dorando Pietri disqualified for being helped across the finishing line by officials? 	OTHER
Argon is normally mixed with 20% of which element in the filling of electric filament lamps? 	OTHER
Which author completed his `Sword Of Honour' in 1961 with the novel `Unconditional Surrender'? 	PERSON
Which land-locked country of North-West Africa beacme an overseas territory of the French Union and was known as French Sudan until it adopted its present name upon independence in 1960? 	LOCATION
Also known as the missing mass, what term is used for the material of uncertain composition thought to comprise 90% or more of the mass of the universe, undetectable except for its gravitational effect? 	OTHER
What name is given to the message which the President of the United States delivers to Congress at the start of each year, roughly equivalent to the Queen's Speech in Britain? 	OTHER
In Greek legend, which daughter of Cassiopeia was chained to a rock as a sacrifice to a sea monster but was rescued by Perseus? 	PERSON
Which character created by the comedian Steve Coogan is noted for his lager drinnking and hatred of students? 	PERSON
What name is given to the Minoan scripty used by the prehistoric inhabitants of Crete and mainland Greece between 1400 and 1200 BC, which was eventually deciphered by Michael Ventris in 1952? 	OTHER
Who entered the University of Konigsberg in 1740 as a theology student, going on fifteen years later to become the Professor of Logic and Metaphysics at the same institution? 	PERSON
Which word has entered the language for the practice of raising the price of, or accepting a higher price for, a house after a lower price has been agreed but before the contracts have actually been exchanged? 	OTHER
In which fourteenth century alliterative poem by William Langford do a series of allegorical visions appear to the narrator in his dreams? 	TITLE
What is the magnitude of the scalar product of two vectors, a and b, if a is perpendicular to b? 	AMOUNT
A privilege granted by the Queen by Letters Patent in 1984, which is the only county entitled to call itself `The Royal County'? 	LOCATION
Which French scientist demonstrated the germ theory of disease by eliminating bacteria from silkworms in the 1860s, and went on to work on anthrax and cholera? 	PERSON
Which Northern Ireland politician has been the leader of the Social Democratic and Labour Party since 1979? 	PERSON
According to the satirical magazine Punch, which single word constituted Mr. Punch's advice to those about to marry? 	OTHER
Of which metallic element is stibnite the ore? 	OTHER
What is the name of the dog on PBS who likes to dress up and act out famous works of literature?	OTHER
When Thetis dipped her son in the river Styx trying to make him immortal she grabbed him by this body part which became an idiom for a point of vulnerability?	OTHER
Name the tie-wearing dog in the Dilbert comic strip.	OTHER
What guitarist died in 1971, a year after his electric Star Spangled Banner rocked Woodstock?	PERSON
What did Ralph Kramden drive in the sitcom "The Honeymooners"?	OTHER
According to the title of the NBC show, what is the occupation of Rachel Burke, the former prosecutor-turned FBI agent working for the Violent Crimes Task Force?	OTHER
Who killed Holofernes by seducing him and beheading him?	PERSON
Who is Chip's Mom in Beauty and the Beast?	PERSON
This toy likes to 'walk' down stairs.	OTHER
What is the toy that has multi-colored blocks, used to build things?	OTHER
A German offensive called the Battle of the Bulge occured during what war?	OTHER
On Fox's 'That 70s Show,' where does the gang like to gather to read comics?	LOCATION
In golf, what is another name for an 'ace'?	OTHER
What obsessive habit did the neighbor boy have in 'American Beauty'?	OTHER
What Akira Kurosawa film is based on MacBeth?	TITLE
Which Zodiacal Sign is represented by a goat?	OTHER
A period of unusually warm weather in fall is given this name.	OTHER
How many sides does an Octagon have?	AMOUNT
If a girl's nickname is Betsy, what is her full first name most likely to be?	OTHER
In what year was CNN launched?	TIMEPOINT
What city was the home to the long-lived band Aerosmith?	LOCATION
What color was the incredible Hulk?	OTHER
What young composer's employers must have known his genius when the retained him as organist in Arnstadt even though he stayed away for 3 months while on a 1 month leave?	PERSON
What is the capital of Ethiopia?	LOCATION
How many weeks a year does the average American adult spend cleaning up in the kitchen after meals?	AMOUNT
How many Sudanese slaves were freed in 1998 because a 4th grade Denver class raised $35,000 to buy their freedom?	AMOUNT
Who was the first U.S. president to have a phone on his desk?	PERSON
What percentage of his wealth has Microsoft's Bill Gates promised to donate this year for children's vaccines in poor countries.	PERCENTAGE
How many American men are married?	AMOUNT
Which major-league pitcher once struck out five batters in one inning.	PERSON
Who discovered chewing gum?	PERSON
What is the most popular participator sport in America?	OTHER
What was St. Patrick's real name? 	PERSON
What band got their name from the sixties movie Barbarella?	OTHER
What is the name of the original comic strip Bill The Cat appeared in?	TITLE
What was the name of the character on the 1st Garbage Pail Kids Pack?	PERSON
What was Max Headroom's network number?	AMOUNT
Which Sci-Fi Sitcom star like to eat cats?	PERSON
Name the late eighties band that named the sides of their first album Hardware and Software and also used samples from Star Trek movies in their songs.	OTHER
Who sang "I Want My MTV" on the Dire Straits song "Money For Nothing"?	PERSON
What 80's game show featured the "Whammy"?	TITLE
Alanis Morrisette appeared on what 80's cable children's show?	TITLE
What was the name of the host of Double Dare?	PERSON
Xavier Roberts was the name associated with which eighties toy?	OTHER
What made Michael Milken famous and rich?	OTHER
What was Maggie Seaver's maiden name on Growing Pains?	OTHER
What did the license plate on the Delorean in Back To The Future spell out?	OTHER
What company made PacMan?	ORGANIZATION
What company made the first color arcade game?	ORGANIZATION
What was the first video Mtv played?	OTHER
What was the first game show on Mtv?	OTHER
What company used the little aligators as it's symbol on clothing?	ORGANIZATION
What was the war during Regan's first term that took place on an island in the carribean?	OTHER
Who shot J.R. Euing?	PERSON
What was the first movie Disney released through a subsidary company that carried an R rating?	TITLE
What were the colors of a Rubik's Cube?	OTHER
What show did the catch phrase, "Yeah, That's The Ticket" originate on?	TITLE
What former communist European country was responsible for producing one of the lamest automobiles of the eighties?	LOCATION
What was E.T.'s favorite candy?	OTHER
Who was the founder of Live Aid?	PERSON
What famous soap opera duo reigned on General Hospital in the eighties?	PERSON
What eighties TV show starred Bruce Willis in a detective agency?	TITLE
Which quicky brunette was one of the first MTv VJs?	PERSON
What was the name of David Hasselhoff's talking car in Knight Ridder?	OTHER
What eighties TV show starred Tom Hanks in women's clothing?	TITLE
What was the name of Eddie Murphy's character in Beverly Hills Cop?	PERSON
What duo lost their Grammy for Best New Artist from the eighties?	OTHER
What late night news show became popular in the eighties after the Iranian Hostage takeover?	TITLE
Who was the female Prime Minister of England throughout the eighties?	PERSON
What TV show with married couples and family life appealed to those over the age of 29?	TITLE
What rock magazine that came out in the eighties is now Rolling Stone's major competitor?	OTHER
Which movie prompted the style of wearing cutoff sweatshirts over the shoulder?	TITLE
In which Fox TV show did Johnny Dep play an undercover cop in high school?	TITLE
Which TV show portrayed the lives of performing arts high school students	TITLE
What time would you watch "Late Night With David Letterman" on NBC?	TIMEPOINT
What father/daughter duo made "Gag Me With A Spoon" a household phrase in the eighties?	OTHER
Which royal wedding of the eighties is now scandelously coming apart?	OTHER
Which pain relieving product was subjected to a public relations scare in the eighties?	OTHER
Who was responsible for the infamous assination attempt on then President Reagan?	PERSON
Name at least three arcade games which contributed to the explosion of mall rats?	OTHER
What major city calls itself 'The Windy City'? 	LOCATION
What are the names of Angelica's parents in the Rugrats? 	PERSON
In the bible, who's name was changed to Israel? 	PERSON
What is the last name of the beardless Z.Z.Top band member? 	PERSON
What was the first name of Sherlock Holmes' Dr. Watson? 	PERSON
Who conquered the castle of Elvas in Portugal? 	PERSON
What was the first newspaper owned by William Randolph Hearst, Senior? 	OTHER
Where is the home location of the 'Blue Angels'? 	LOCATION
In what story did Sherlock Holmes make his debut? 	TITLE
Charlemagne ruled a large part of western and central Europe in the years?	DURATION
How long is the national anthem of Greece?	DURATION
What relationship was Jesus to John the Baptist? 	OTHER
Who was the actress in the 1944 film that said 'You know how to whistle, don't you? You just put your lips together - and blow.'?	PERSON
What is the oldest college in the U.S.?	ORGANIZATION
Who was the captain of the Pottsville Maroons football team in 1925?	PERSON
What President promised a chicken in every pot?	PERSON
What was the name of the dynasty of the french kings that ended under the French Revolution? 	OTHER
Which prominent African-American singer was nominated for a Best Actress Oscar in 1972?	PERSON
Who is considered the father of Modern Geology? 	PERSON
How many time zones are there in the world? 	AMOUNT
What is a 300th anniversary called? 	OTHER
What was the Tin Man's name in the Wizard of Oz?	OTHER
What is the play West Side Story based on? 	OTHER
What country is Cornelius Drebbel from?	LOCATION
What is the name of the most southerly village in mainland Britain?	LOCATION
What is the longest bone in the body? 	OTHER
Which city had the first movie theatre in the US? 	LOCATION
Who directed 8 Man?	PERSON
Who was the director of Godzilla, King of Monsters?	PERSON
What is the name of the cape at the southernmost tip of Africa? 	LOCATION
How many cows does it take to supply the NFL in footballs for one year?	AMOUNT
What was the name of the first steam-powered warship? 	OTHER
How many men who signed the Declaration of Independence in 1776 later became US presidents?	AMOUNT
How many bones are there in the inner ear?	AMOUNT
What was the code name of the D-Day invasion? 	OTHER
In Greek mythology, who were the god Zeus' parents?	PERSON
In what year did National Geographic magazine start? 	TIMEPOINT
On what river is the city of Cincinnati located? 	LOCATION
Which actress hired a private investigator to find David Strickland before it was too late? 	PERSON
Who was the first Australian Secretary General to the General Assembly of the United Nations? 	PERSON
Who is the lead singer for Stone Temple Pilots? 	PERSON
What American president had a marijuana patch in his backyard?	PERSON
What type of animal is 'Shardik', in Richard Adams' novel of the same name?	OTHER
Who was the bowler whom Sobers hit for 6 sixes in an over?	PERSON
What is the largest county in the United states? 	LOCATION
Stephen King has written 5 books under what pseudonym?	PERSON
What year did Rolf Harris have an Australian Top 10 hit with 'Two little boys, with Two little toys..'?	TIMEPOINT
What letter does not appear anywhere on the periodic table of elements? 	OTHER
What is the capital city of the Cote d'Ivoire?	LOCATION
What does the postage stamp cancellation O.H.M.S. mean? 	DEFINITION
Of all the planets - which is the largest?	OTHER
What is the dry ingredient in a roux?	OTHER
What U.S. city's state capitol is located 5280 ft. above sea level? 	LOCATION
What was the crime committed for those dwelling in Dante's lowest level of hell in his work, 'The Inferno'? 	OTHER
What was the last animal to be tamed as a food source? 	OTHER
Where is Arthur C. Clarke presently residing?	LOCATION
When was the constitution fully ratified? 	TIMEPOINT
In what famous sci fi flick did an Einsteinlike scientist say to a space alien 'sit down. I have several thousand questions I'd like to ask you'? 	TITLE
What animal has the largest penis size in proportion to its body size? 	OTHER
How many 'joeys' can a female kangaroo have in her pouch at one time?	AMOUNT
In which Dr. Seuss book did the word 'nerd' first appear?	TITLE
In what US state was the Phillips head screwdriver invented? 	LOCATION
On what day was Mother Teresa awarded the nobel peace prize? 	TIMEPOINT
How many sheets of paper are in a ream?	AMOUNT
Who set the train speed record of 552 kph on April 14 1999?	PERSON
In Disney comics, who are Daisy Duck's three nieces?	PERSON
The word 'poltergeist' comes from what language?	OTHER
In the movie 'Shaft', what was Shaft's first name? 	PERSON
What is the airport code for Hartford CT? 	OTHER
In the movie Tommy Boy, who played Richard?	PERSON
Who leads the National Hockey League in all-time playoff penalty minutes? 	PERSON
What sense does a dying person lose first? 	OTHER
Who was Johnny Carson's first guest on 'The Tonight Show' on October 1st, 1962? 	PERSON
Jane Asher's (Paul McCartney's 60's girlfriend) brother was in what early 60's group? 	OTHER
Who was the only person to appear on both 'Kids in the Hall' and 'Saturday Night Live?'	PERSON
Who directed all James Bond films up to the recent 'The World is not enough'? 	PERSON
What is the name of the theme song from M*A*S*H?	TITLE
Ford had a problem in Brazil when the Pinto wouldn't sell. Ford later found out Pinto was Brazilian slang for what? 	OTHER
What was Columbos' dogs name?	PERSON
Who discovered King Tut's tomb? 	PERSON
In what year was King Tut's tomb discovered? 	TIMEPOINT
What was used to signal advance into battle in World War I for the East Surrey Regiment? 	OTHER
What year was the NBA formed? 	TIMEPOINT
In what year was the Louisiana Purchase?	TIMEPOINT
At the battle of Antietam, who commanded the XII Corps for the Union side? 	PERSON
Who was the most famous gorgon? 	PERSON
What was the name of the comic book character who couldn't talk, but replied to all by making sounds? 	PERSON
Kinsey Millhone is a recurring character in what author's series of novels?	PERSON
What was the original color of the white house? 	OTHER
Who starred in the movie 'Highpoint'?	PERSON
What language spoken by the ancient Babylonians?	OTHER
Which U.S. president entertained his friends by writing Latin with one hand and Greek with the other.	PERSON
Which Peanuts character plays the piano?	PERSON
Who is credited with coining the phrase, 'M'Kay?'	PERSON
In which US city were the first electric traffic lights installed?	LOCATION
Which is the most densely populated state?	LOCATION
What did Roland Garros create in 1915? 	OTHER
Who invented the fighter plane?	PERSON
What was Cyndi Lauper's dog named?	OTHER
What is the largest Rotary Club in terms of members outside of North America?	OTHER
What is the state capital of Wisconsin? 	LOCATION
According to the bible, what is the root of all evil? 	OTHER
Name Cheech's cousin in the movie 'Cheech & Chong's Up in Smoke'.	PERSON
Who invented the potato chip? 	PERSON
What element on the Periodic Table has the symbol W?	OTHER
What is the only US state with a diamond mine? 	LOCATION
Where is the Indian chief Geronimo buried? 	LOCATION
What does the "G" in the movie ratings stand for?	OTHER
When does Summer officially begin?	TIMEPOINT
What was Woodstock, that lovable friend of Snoopy's, favorite winter sport?	OTHER
What dice game invented by a wealthy Canadian Couple in 1956 was originally called the "Yacht Game"?	OTHER
Maurice Sendak, author of the popular children's book "In the Night Kitchen" also wrote an award-winning book on monsters.  What is the title of this book?	TITLE
What sport was invented by a YMCA Instructor in Springfield, Massachusetts in 1891?	OTHER
What percentage of gun-owning households with children do not always keep their guns locked in a secure place?	PERCENTAGE
How many weeks of unpaid, job-protected leave does the Family Medical Leave Act allow?	AMOUNT
Who was the youngest athlete to win a gold medal at the Winter Olympics?	PERSON
Which famous composer wrote "Twinkle, Twinkle Little Star" at age six?	PERSON
How much does the average teenager get in weekly allowance?	MONEY
What is the name of the pollen-producing structure of a flower?	OTHER
In "The Adventure of Superman" the natural parents of Clark Kent sent him to Earth in a rocket which landed in which American town?	LOCATION
What 17th Century Irish Archbishop added up the ages of all the people in the Bible and concluded that Creation had occurred in 4004 B.C.?	PERSON
What is the largest system of island groups in the world.	LOCATION
What does a camel's hump contain?	OTHER
Who is the only major league pitcher to retire immediately after a 27-win season?	PERSON
Which race was Greg LaMond the first American to win?	OTHER
Which Law & Order seasoned actor also was smart enough to win $34,000 for his favorite charity on 'Celebrity Jeopardy!'?	PERSON
What is the name of the long, whiplike extensions on sperm cells which enable them to swim?	OTHER
What legendary attorney represented Leopold and Loeb, among other pariahs?	PERSON
On Spin City, for what position did Mike hire Caitlan Moore, played by Heather Locklear?	OTHER
For what team did Bob Feller pitch an opening day no-hitter?	ORGANIZATION
What British physicist and chemist is best known for his discoveries in the fields of electricity and magnetism.	PERSON
What woman is once again the Pakistani Prime Minister?	PERSON
Who is the author of "A Farewell to Arms".	PERSON
Annie Lennox was originally the lead singer of what group, with husband Dave Stewart?	OTHER
Tom Selleck portrayed which character in the detective series "The Rockford Files"?	PERSON
Who was the first character in "The Wizard of Oz" to wear the Ruby Slippers?	PERSON
What absurdist playwright wrote the original lyrics for "Mack the Knife"?	PERSON
Which organ in the Endocrine system controls the functions of all of the others?	OTHER
What form of Buddhism is prevalent in Sri Lanka, Thailand, Cambodia, Laos and Myanmar?	OTHER
Throwing for 318 yards, who was the MVP of Super Bowl XIII?	PERSON
How many judges are on the US Supreme Court?	AMOUNT
What percentage of medical school graduates were women, 1998-99?	PERCENTAGE
What percentage of U.S. adults suffer from hypertension (high blood pressure).	PERCENTAGE
What year was "You Bet Your Life" first broadcast on television?	TIMEPOINT
When was the Princeton University Chapel constructed?	TIMEPOINT
In 1934 a summer camp for boys formed in Griggstown. Which group was the sponsor?	ORGANIZATION
Of the known animal species, what percent are insects?	PERCENTAGE
Which country's workers expressed the highest degree of job dissatisfaction?	LOCATION
Which country has the highest number of highway deaths per 100,000 population?	LOCATION
What unit of measure is used in calculating the diameter of a cigar?	OTHER
Which president is buried in Princeton?	PERSON
What are the top two silver producing countries?	LOCATION
What proportion of the nation's freight bill is accounted for by trucks?	PERCENTAGE
Which country had the greatest sale of over-the-counter health care products per capita in 1999?	LOCATION
How long did "Gunsmoke" run on network TV?	DURATION
What percentage of new medicines receiving FDA approval in 1999 were developed by research-based pharmaceutical companies headquartered in New Jersey?	PERCENTAGE
What percentage of the 2.5 million Muslims in the United States are followers of Louis Farrakhan's Nation of Islam?	PERCENTAGE
At what income would a family of four be living in poverty?	MONEY
How many items are typically for sale on eBay, the Internet auction site?	AMOUNT
How much does a cumulus cloud with a volume of one-quarter cubic mile weigh?	AMOUNT
IBM announced the personal computer in what year?	TIMEPOINT
How long does it take a newly-planted cranberry bog to produce marketable berries?	DURATION
When should you applaud during a Shakespeare performance according to "Shakespeare for Dummies"?	TIMEPOINT
Who was the designer of the "American Modern" dinnerware?	PERSON
How long is the train ride from London to Paris?	DURATION
In what state is the oldest operating lighthouse in the United States located?	LOCATION
Of the estimated 6,000 to 8,000 poisonous snake bites in the United States each year, how many are fatal?	AMOUNT
What was Michelangelo's last name?	PERSON
What percent of women with children under 3 send pictures of their babies via e-mail?	PERCENTAGE
What is the largest island adjoining the continental United States?	LOCATION
Who was originally cast as Rick in "Casablanca," a role eventually played by Humphrey Bogart?	PERSON
What lubricant was used to help slide the 4,800-ton Hatteras Lighthouse when it was moved 2,900 feet from its original site by sliding it along steel beams?	OTHER
How do birds find worms that are underground?	OTHER
What city was Adolph Hitler referring to when he wrote in "Mein Kampf," that his years there were "a time of the greatest transformation which I have ever been through."?	LOCATION
During 1999, how many days passed before a new Home Depot store opened, on average?	DURATION
Which famous writer said, "I find it harder and harder every day to live up to my blue china."	PERSON
What company earned the most U.S. patents in 1999?	ORGANIZATION
Which Somerset County municipality had the highest proportion of persons 18 years old and younger in 1990?	LOCATION
Approximately when did the Vikings first land in North America?	TIMEPOINT
What does the Pentagon say its version of the proposed "space shield" missile-defense system will cost?	MONEY
What percentage of Americans receive food stamps?	PERCENTAGE
What is the most researched honeymoon and romance destination at Travelocity.com?	LOCATION
What was the peak year for accidents during the 1990s on the N.J. Turnpike?	TIMEPOINT
How much more did the average CEO of a major U.S. company make last year than the average worker?	MONEY
n what country are Big Macs most expensive?	LOCATION
Which country spent the most per capita on recorded music last year?	LOCATION
In what part of the country are retail gasoline prices the lowest?	LOCATION
What is the approximate maximum distance at which a clap of thunder can be heard?	DISTANCE
How many vehicles are owned or leased by the U.S. federal government?	AMOUNT
Which city outside the United States ranked first in Internet domain registrations in January 2000?	LOCATION
How high is the pitcher's mound in Major League baseball?	DISTANCE
What is the average price today of a new car?	MONEY
What is the richest city neighborhood in America?	LOCATION
What is the cost of the optimal daily diet for a woman aged 25 to 50?	MONEY
What percentage of American high school students are enrolled in daily physical education classes?	PERCENTAGE
What percentage of suspects charged with crimes make confessions to police?	PERCENTAGE
Which Major League Baseball team charges the most for a hot dog?	ORGANIZATION
What percentage of fatal traffic accidents in New Jersey in 1995 were alcohol related?	PERCENTAGE
Which library has the largest collection in the world?	OTHER
Which New Jersey college ranked highest on Yahoo! Internet Life's list of "100 Most Wired Colleges?"	ORGANIZATION
What is New Jersey's top-rated seafood restaurant in the 2000 Zagat Survey?	ORGANIZATION
Southwest Airlines was rated the top U.S. airline in a national study released last week. Which airline finished second?	ORGANIZATION
What percentage of Africa's population lives without access to basic healthcare or a safe water source?	PERCENTAGE
Which nation has the "most global economy?"	LOCATION
What percentage of total federal income tax collections come from corporations?	PERCENTAGE
What is the total federal tax take, in percentage terms, for a family of four at the national median income of $39,000?	PERCENTAGE
What percentage of people polled in New Jersey believe that God created the Earth in six days?	PERCENTAGE
Which type of treatment for back pain produced the best results among those polled by Consumer Reports?	OTHER
What is the latest date at least one inch of snow fell in New Brunswick during a 24-hour period?	TIMEPOINT
Which college or university has the largest number of graduates serving in the Peace Corps?	ORGANIZATION
Which of the 50 largest cities in the United States had the lowest unemployment rate in 1998?	LOCATION
Which of the following female pop musicians has yet to reach her 40th birthday?	PERSON
What has been the average inflation-adjusted return on stocks during the 200-year history of the stock market?	PERCENTAGE
What percentage of computer monitors used in the home are set with a screen resolution of 800 by 600 pixels?	PERCENTAGE
What percentage of New Jersey residents drink bottled or filtered water?	PERCENTAGE
What percentage of people use e-mail to circulate jokes?	PERCENTAGE
What was Internet Explorer's browser market share in February?	PERCENTAGE
Which New Jersey daily newspaper showed the largest circulation gain in 1998?	OTHER
What percentage of Americans polled believe government should pass laws on how personal information is collected on the Internet?	PERCENTAGE
What percentage of the copies printed by People magazine are sold?	PERCENTAGE
What percentage of Princeton University's 734 professors are African American?	PERCENTAGE
How many foreign travelers visited Guyana in 1998?	AMOUNT
A recent poll found that just one country of 17 surveyed had a majority of people that were willing to pay more taxes to fund better services. Which country was it?	LOCATION
Mexico is the leading source of illegal immigration to the United States. Which country ranks second?	LOCATION
Thirty-nine states have raised the speed limit on at least some of their highways since 1995. How many of those states have shown statistically significant increases in fatalities as a result?	AMOUNT
If gas sells at $1.50 a gallon, how much does it cost to fill up a Ford Excursion SUV?	MONEY
What percentage of Americans pay the full amount due on their credit cards each month?	PERCENTAGE
What percentage of federal tax returns were filed electronically last year?	PERCENTAGE
What percentage of web pages worldwide are in English?	PERCENTAGE
What disease received the most research funding from the National Institutes of Health?	OTHER
What percentage of high school juniors spend less than an hour a day on homework?	PERCENTAGE
In how many states is execution by firing squad still an authorized method?	AMOUNT
In what county of Ireland did St. Patrick spend his retirement years?	LOCATION
What is the favorite color of car owners today?	OTHER
Which country has the highest percentage of women elected to its national legislative body?	LOCATION
What percentage of male professionals and managers in the U.S. work at least 50 hours per week and spend an additional four hours commuting?	PERCENTAGE
What percentage of Division I male college basketball players graduate within six years from the time they first enroll?	PERCENTAGE
What percentage of households with Internet access have cable modems or DSL connections?	PERCENTAGE
How many heart transplants are expected to be performed in the United States this year?	AMOUNT
In 1992, Ross Perot received the most votes by a third-party presidential candidate in 80 years. Which third-party candidate drew the most votes between the Depression years and 1992?	PERSON
Which organization or company spent the most money lobbying in New Jersey last year?	ORGANIZATION
Which HMO has the most enrollees in New Jersey?	ORGANIZATION
In 1960, what percentage of female high school graduates went on to college?	PERCENTAGE
What was the top salary last year for a staff lawyer at the ACLU in New York City?	MONEY
What is the most effective treatment today for bubonic plague?	OTHER
What percentage of banks in New Jersey offer some form of free checking?	PERCENTAGE
Entering tonight's game with Yale, the Princeton's men's basketball team has lost two straight to Penn and Yale. What is the last Ivy League team other than Penn or Yale to beat the Tigers twice in a row?	ORGANIZATION
How many hours did the average Internet user spend online at home during the month of January?	AMOUNT
In what year was the first America's Cup race held?	TIMEPOINT
What is the most popular out-of-state college among students from New Jersey?	ORGANIZATION
What percentage of acute care beds in New Jersey hospitals were occupied in 1998?	PERCENTAGE
Where is the largest science and research park in the United States?	LOCATION
Since the 1980-81 season, which Ivy League men's basketball team has had the most Rookies of the Year?	ORGANIZATION
What percentage of people over the age of 80 suffer from some degree of dementia?	PERCENTAGE
Which U.S. corporation donates the most money to the arts and humanities?	ORGANIZATION
Which state has the lowest pupil-to-teacher ratio in its public schools?	LOCATION
Which insurance company charges the most for a standard homeowners policy in Mercer County?	ORGANIZATION
What is the most expensive city in the world for business travelers?	LOCATION
Which university web site draws the most unique visitors?	ORGANIZATION
How many times during the past 15 years has the Princeton men's basketball team lost more than 10 games in a season?	AMOUNT
What was Rubin "Hurricane" Carter's boxing record at the time he was charged with triple murder?	AMOUNT
What percentage of the world's prison population is incarcerated in American jails?	PERCENTAGE
How many men convicted of murder or rape in the United States have been freed because of new DNA evidence?	AMOUNT
What is the top-rated Cajun/Southern restaurant in New Jersey in the 2000 Zagat Survey?	ORGANIZATION
What is the most popular domestic travel destination for Americans?	LOCATION
Which U.S. city is rated 'Most Wired' by Yahoo! Internet Life magazine?	LOCATION
When was the last time the Dartmouth basketball team, Princeton's opponent tonight, won the Ivy League championship?	TIMEPOINT
Which casino in Atlantic City has the most slot machines?	ORGANIZATION
What percentage of Princeton undergraduates receive some financial aid from the university?	PERCENTAGE
How many different web sites did the average user of the Internet visit in December?	AMOUNT
What percentage of the $500 billion in tax cuts proposed by Sen. John McCain over the next 10 years would benefit the bottom three-fifths of American taxpayers?	PERCENTAGE
Which state among those with a single flat rate for all taxpayers has the lowest income tax?	LOCATION
How many players from Brown University were first-team, all-Ivy basketball selections in the 1980s and 1990s?	AMOUNT
What was the most-watched television broadcast of all time?	OTHER
What is the world's busiest airport, measured by volume of cargo loaded and unloaded annually?	OTHER
What percentage of high school students in New Jersey reported having tried marijuana at least once?	PERCENTAGE
How much did the median net worth of U.S. households making $10,000 to $25,000 a year rise or fall between 1995 and 1998?	MONEY
Brown has the lowest winning percentage against Princeton among Ivy League basketball teams. Which team has the second worst record?	ORGANIZATION
What percentage of money raised by New Jersey's state legislative and party leaders for the November elections came from corporations, law firms and other non-voting entities?	PERCENTAGE
How many calories can you burn off by walking or running one mile?	AMOUNT
What is the most popular bachelor's degree program in New Jersey?	OTHER
What percentage of the typical retiree's income comes from Social Security?	PERCENTAGE
What is the Princeton University basketball team's all-time winning percentage against Catholic University, its opponent Monday night?	PERCENTAGE
How many Iraqi children have died as a result of U.S. economic sanctions against Iraq since 1990?	AMOUNT
How much will it cost per month to send a child born today to an Ivy League school in the year 2019, given annual tuition increases of 4.5 percent?	MONEY
How much has the inflation-adjusted income of the poorest one-fifth of New Jersey families changed over the past decade?	MONEY
Which European nation is expected to have the largest percentage increase in population over the next 50 years?	LOCATION
What is the coldest temperature on record in New Brunswick?	AMOUNT
Which is the most active U.S. commercial port, measured in overall import and export tonnage?	LOCATION
What is the best state in which to raise a child, according to the Children's Rights Council?	LOCATION
What is the Ivy League women's basketball record for most three-point field goals in a game by one player?	AMOUNT
How many times had the chief prosecution witness in the trial of Mumia Abu-Jamal been arrested herself when she testified against him?	AMOUNT
About how many people in the United States die each year from the flu?	AMOUNT
Which major market in the United States has the highest Internet penetration?	OTHER
Who is the richest American under the age of 40?	PERSON
What stock performed best during 1999?	OTHER
Who has been the single largest contributor to Bill Bradley's political campaigns?	PERSON
Which of the nation's 100 largest cities has the highest maximum salary for teachers?	LOCATION
Princeton University has played 34 basketball games at home against Lafayette College, its opponent Saturday night. How many of those games has Lafayette won?	AMOUNT
What percentage of newspapers in the U.S. say they are making a profit from their online site?	PERCENTAGE
How many display advertisements appear in print publications in North America each day?	AMOUNT
What was the most popular name for American baby girls in 1999?	PERSON
Which nation has the highest percentage of its population incarcerated?	LOCATION
What percentage of people with a mental disorder seek professional counseling at some point during their lives?	PERCENTAGE
Which major U.S. airline had the lowest consumer complaint rate last year?	ORGANIZATION
What is the record-low temperature this century for New Year's Eve Day in New Brunswick?	AMOUNT
When was the last time the Princeton basketball team defeated Holy Cross, its opponent in Friday's game?	TIMEPOINT
What does foo-foo mean in "Caribbean English?"	OTHER
Which nation generates the most revenue from tourism?	LOCATION
When is the last time an Ivy League basketball team other than Penn or Princeton won an NCAA tournament game?	TIMEPOINT
During what decade was Christmas first widely celebrated by Americans?	TIMEPOINT
Which Caribbean resort received the highest rating from readers of CondeNast Traveler magazine?	ORGANIZATION
What was the largest jury verdict awarded to an individual last year?	MONEY
What is the friendliest state in the U.S. for entrepreneurs?	LOCATION
How many users are there worldwide on the Web?	AMOUNT
What is the record for most snowfall in a single December day in New Brunswick?	DISTANCE
In how many states is it legal to carry concealed weapons?	AMOUNT
How many ships were there in the U.S. Navy in the 1830s?	AMOUNT
Against which non-league opponent does the Princeton University basketball team have the highest all-time winning percentage? (Minimum 10 games)	ORGANIZATION
Which city generates the highest levels of sulphur dioxide in the world?	LOCATION
What was the population of Princeton Borough when it became incorporated as a separate municipality in 1813?	AMOUNT
How many gallons of water are used to produce the chips in one computer?	AMOUNT
Who has the best pizza in the New Jersey according to the 2000 Zagat Survey?	ORGANIZATION
Who is the richest member of Congress?	PERSON
What is the cost of making New Jersey state agencies Y2K compliant?	MONEY
What is the Princeton men's basketball team's won-lost percentage against Rutgers over the past 20 years?	PERCENTAGE
What country is the most popular destination for college students studying abroad?	LOCATION
How many e-mail messages does the average U.S. household send and receive per week?	AMOUNT
Which ski resort was named the best in North America by readers of Conde Nast Traveler magazine?	ORGANIZATION
How expensive would gas have to become, per gallon, before most consumers would be willing to trade in their current cars for more fuel-efficient models?	MONEY
How many prescriptions for anti-depressants were filled in the United States last year?	AMOUNT
How much are Salvadoran workers paid for each $198 Liz Claiborne jacket they sew?	MONEY
Which Ivy League basketball player scored the most points in a single game during the 1990s?	PERSON
What is the fuel capacity, in gallons, of the Battleship USS New Jersey?	AMOUNT
What percentage of European Internet users have access from their homes?	PERCENTAGE
What percentage of suicide attempts involving pills or poison is successful?	PERCENTAGE
What percentage of large U.S. companies reviews employee e-mail?	PERCENTAGE
How many Americans will have traveled 100 miles or more during the Thanksgiving weekend?	AMOUNT
What percentage of the discretionary funding in the federal budget goes to the Pentagon?	PERCENTAGE
What is the lowest single-game point total for a Princeton University basketball team in the last 20 years?	AMOUNT
What year did the Pilgrims have their first Thanksgiving feast?	TIMEPOINT
What percentage of Internet users have never purchased anything online?	PERCENTAGE
Which desktop computers have the best repair history according to a survey of Consumer Reports readers?	OTHER
What percentage of professors at Princeton University are black or Hispanic?	PERCENTAGE
Who is the top recording artist in Russia?	PERSON
The Princeton University football team has played 78 different opponents in its 130-year history. How many of those teams have a winning record against the Tigers?	AMOUNT
What is the lowest temperature ever recorded in November in New Brunswick?	AMOUNT
What is the most popular search query on Lycos?	OTHER
What is the best overall miles per gallon rating for a 2000 model sport utility vehicle?	AMOUNT
Which U.S. airport received the highest rating in Conde Nast Traveler magazine's 1999 Readers' Choice Awards?	OTHER
What percentage of the 389 top corporate CEOs who have made donations to the presidential election campaign have contributed to George W. Bush?	PERCENTAGE
Which primetime television program has the highest ratings this season?	TITLE
When was the last time either the Yale or Brown football teams, currently tied for first place in the Ivy League, won the league title outright?	TIMEPOINT
What was the median starting salary for journalism school graduates last year?	MONEY
Which pro sports franchise has the highest market value?	ORGANIZATION
Which restaurant in New Jersey serves the best brunch, according to the Zagat Survey?	ORGANIZATION
What percentage of federal employees received "unacceptable" performance ratings in 1996?	PERCENTAGE
Which actress has been in the most movies that have grossed more than $100 million?	PERSON
Who is the winningest football coach in Ivy League history?	PERSON
How many hours a week is the average truck driver on the road?	AMOUNT
Who is the most popular employer among college juniors and seniors?	ORGANIZATION
Which nation has the lowest suicide rate in Europe?	LOCATION
What percentage of the tax breaks included in the Lazio-Condit minimum wage bill would go to the wealthiest 1 percent of taxpayers?	PERCENTAGE
Which county in New Jersey has the highest percentage of female arrests?	LOCATION
During what decade did the Halloween custom come to America?	TIMEPOINT
What is the web surfer's No. 1 frustration with web sites?	OTHER
How many times in its 68 meetings with Princeton has Columbia, the Tigers' football opponent Saturday, scored more than 24 points?	AMOUNT
What percentage of high school graduates who come from homes with family income of less than $25,000 attend college?	PERCENTAGE
What is the average work week of an American father with children under 18 years of age?	DURATION
In 1980, political parties raised $19 million in "soft money." How much does Common Cause estimate will be raised in the 2000 elections?	MONEY
What is the most Internet-accessible city in the United States?	LOCATION
How many U.S. newspapers are among the 20 most widely circulated dailies in the world?	AMOUNT
When is the last time either Princeton or Harvard has scored more than 28 points against each other?	TIMEPOINT
What percentage of the U.S. carbonated soft drink market is controlled by Coca-Cola, Pepsi-Cola and Dr. Pepper/Seven Up?	PERCENTAGE
There were 677 cases of gonorrhea reported in Trenton in 1998. How many cases were reported in the rest of Mercer County?	AMOUNT
In 1996, the wealth of the world's 447 billionaires was equal to that of what percentage of the world's least affluent population?	PERCENTAGE
Which of the following companies took the worst beating in the stock market last week?	ORGANIZATION
What is the coldest temperature ever recorded in New Brunswick in October?	AMOUNT
What is the Princeton University football team's post-World War II record for most consecutive losing seasons?	AMOUNT
Which sports utility van is considered the safest on the road by Money magazine?	OTHER
Which book is most commonly found on the shelves of libraries here and in other countries?	TITLE
What percentage of Americans with a household income of $75,000 or more use the Internet?	PERCENTAGE
What percentage of American women think they are "happier than their grandmother's generation?"	PERCENTAGE
What name has been the most popular among newborn boys in New Jersey for each of the past eight years?	PERSON
What percentage of employees say they surf the Web at work at least a few times a day?	PERCENTAGE
Which Ivy League university has the highest graduation rate for black students?	ORGANIZATION
Which quarterback holds the Ivy League record for most passing yardage in a single season?	PERSON
Over the past 35 years, when was defense spending, as a percentage of the total federal budget, at its lowest level?	TIMEPOINT
Which restaurant in the Princeton-Trenton-New Brunswick-Lambertville area had the highest overall rating for food, decor and service in the most recent Zagat Survey of restaurants?	ORGANIZATION
Which town has the highest per-capita income in Mercer, Middlesex, Somerset and Hunterdon counties?	LOCATION
What percentage of Americans held college degrees in the early 1960s?	PERCENTAGE
Which hotel was rated the best in New York City by readers of Travel & Leisure magazine?	ORGANIZATION
Which letter in the Princeton-Suburban phone book has the most pages of listings?	OTHER
Neither Columbia nor Brown has won an Ivy League title in football in more than 20 years. Which team has the third-longest Ivy title drought?	ORGANIZATION
What percentage of stories aired on PBS during a sample two-week period dealt with international news?	PERCENTAGE
How many of the 18 U.S. presidents who served in the 20th century were graduated from Ivy League schools?	AMOUNT
When was the cannon on Princeton University's Cannon Green first brought to the campus?	TIMEPOINT
How far in miles does the typical mouthful of food travel from farm to consumer?	DISTANCE
Which Ivy League opponent has the Princeton University football team had the most success with during the 1990s?	ORGANIZATION
What percentage of Web shoppers who place something in their shopping carts complete their shopping transactions?	PERCENTAGE
Who founded Evelyn College for Women, which operated in Princeton in the latter part of the 19th century?	PERSON
Which city is the greatest distance from New York City?	LOCATION
In what year was the new Woodrow Wilson School for International Studies at Princeton University dedicated?	TIMEPOINT
Which country has the highest life expectancy?	LOCATION
Which soft drink has the most calories?	OTHER
How many times during the past 15 years has a Princeton University football player won the Ivy League Rookie of the Year award?	AMOUNT
Of the 20 top-rated television programs last week, how many were "news magazine" shows?	AMOUNT
In 1960, when the average male's life expectancy was 68, how many of those years were spent working?	DURATION
What was the top grossing Broadway show the first week of this month?	TITLE
Which town had the lowest crime rate in Middlesex, Mercer and Somerset counties in 1998?	LOCATION
Of the 20 leading occupations for women, which is the highest paying?	OTHER
How much are U.S. federal, state and local agencies expected to spend this year to fight the war on drugs?	MONEY
What percentage of American adults who die leave taxable estates?	PERCENTAGE
Name two U.S. vice presidents who were born in New Jersey?	PERSON
Which nation's employees in the industrialized world put in the longest working hours?	LOCATION
Which country has the highest recycling rate for glass?	LOCATION
Which U.S. city had the most homicides last year?	LOCATION
Which island was rated the favorite of Travel & Leisure readers in the magazine's annual "World Best Awards?"	LOCATION
Which country has the world's largest underground economy?	LOCATION
Which restaurant in Princeton received the highest composite score (food, service, decor) in the new Zagat Survey?	ORGANIZATION
What percentage of the corn crop in this country is genetically engineered?	PERCENTAGE
In what year was Nassau Hall first occupied?	TIMEPOINT
How many passengers did Delta bump in the first three months of this year?	AMOUNT
What was the average room rate for a hotel room in Manhattan during the first six months of this year? 	MONEY
Which country has the least amount of government interference in its economy?	LOCATION
Which car has the highest retail resale value?	OTHER
Which search engine covers the largest percentage of Web pages?	OTHER
What percentage of jail inmates were using drugs or alcohol at the time of the offense for which they were incarcerated?	PERCENTAGE
What percentage of people watch less TV today than they did prior to the Internet?	PERCENTAGE
How many of the 18 freshmen defensive players listed on this fall's Princeton University football team weigh more than 240 pounds?	AMOUNT
Which country has the highest per-capita incidence of AIDS?	LOCATION
How many U.S. presidents have visited the Morven mansion in Princeton?	AMOUNT
How many New Jersey residents have drinking water that comes from sources deemed "unsafe" for fishing or swimming?	AMOUNT
What is the record for the most rainfall in a single day in August in New Brunswick?	DISTANCE
Which country has the world's highest divorce rate?	LOCATION
In what year was Route 206 in the Princetons completed?	TIMEPOINT
Which country has the most Internet users, per capita?	LOCATION
During the past 25 years, what has been the average number of mass murder incidents in the U.S. each year?	AMOUNT
What percentage of the estimated 800 million pages that exist on the Web are pornographic?	PERCENTAGE
What percentage of residents in the Netherlands reported using marijuana during the "past month"?	PERCENTAGE
What's the best-selling paperback on the Publishers Weekly list?	TITLE
Which state consumes the most catfish?	LOCATION
How far below normal are the water levels at the state's major reservoirs?	DISTANCE
There are 566 municipalities in New Jersey. How many were there in 1880?	AMOUNT
In what year did the number of acts of international terrorism peak?	TIMEPOINT
What percentage of men over the age of 75 who were polled in an AARP survey said that sexual activity was important to their overall quality of life?	PERCENTAGE
Which hospital in New Jersey has the lowest risk-adjusted mortality rate for coronary artery bypass surgery?	ORGANIZATION
What is the monetary cutoff for filing a damages claim in Small Claims Court in New Jersey?	MONEY
Which New Jersey county experienced the most population growth, in percentage terms, between July 1997 and July 1998?	LOCATION
Which organization spent the most money on lobbying in New Jersey last year?	ORGANIZATION
What was the most popular name given to baby girls in England and Wales last year?	PERSON
What is the median age of cars in the U.S.?	Y
What is the minimum eyesight requirement for obtaining a driver's license in New Jersey?	AMOUNT
What percentage of men visited a dentist in 1997?	PERCENTAGE
What is the coldest temperature ever recorded in New Brunswick in July?	AMOUNT
Which airport in Europe has the highest percentage of delayed departures?	OTHER
How many golf courses are owned and operated by the state of New Jersey?	AMOUNT
What is the most popular content area on newspaper web sites?	OTHER
Which public college in New Jersey will have the largest tuition increase in 1999-2000?	ORGANIZATION
Where was the deadliest hurricane in the United States this century?	LOCATION
How many times does the average NYTimes.com user access the site each month?	AMOUNT
Who won the Yahoo! Online Music Award for "Best Official Artist Site?"	PERSON
What is the average life expectancy in Third World nations?	TIMEPOINT
In what year was the FitzRandolph Gate, the main entrance to the campus of Princeton University, erected?	TIMEPOINT
In what town is the most expensive apartment complex listed in a statewide apartment guide located?	LOCATION
What was the debut event at Brendan Byrne Meadowlands Arena in 1981?	OTHER
Which country has the most soldiers and rebels under the age of 18?	LOCATION
What percentage of employees say they would vote in favor of forming a union at their workplace?	PERCENTAGE
Which college or university raised the most money from alumni, corporations and private donors in 1997-98?	ORGANIZATION
What percentage of children could qualify as learning disabled under either the federal or state definitions?	PERCENTAGE
Which municipality in New Jersey had the largest percentage increase in population between 1990 and 1998?	LOCATION
Which state has the nation's highest percentage of teen pregnancies ending in abortion?	LOCATION
How many more, or fewer, people are living in abject poverty today than at the beginning of this decade?	AMOUNT
How many of the 29 magazine and newspaper Web sites included in min's New Media Report survey reported increases in page views from April to May?	AMOUNT
What is the warmest temperature ever recorded in New Brunswick?	AMOUNT
In how many Shore towns in New Jersey is access to all the beaches free?	AMOUNT
What percentage of immigrants who had been in the U.S. for at least 25 years owned their own homes in 1996?	PERCENTAGE
What percentage of high school girls surveyed agreed with the statement that people will be happier if they marry rather than stay single?	PERCENTAGE
How many states ban all fireworks?	AMOUNT
How much did the juvenile violent crime rate rise or fall between 1993 and 1997?	PERSON
Which Superior Court judge in Mercer, Middlesex, Somerset and Hunterdon counties had the most decisions overturned on appeal in 1998?	PERSON
How many Americans are bitten each year by dogs?	AMOUNT
What percentage of the 41,000 Americans killed in motor vehicle accidents in 1997 were male? 	PERCENTAGE
What percentage of Web users don't receive at least one spam e-mail message a week? 	PERCENTAGE
What is the maximum amount of damages you can recover in Small Claims Court in New Jersey?	MONEY
What is New York City's most prestigious coop apartment building? 	OTHER
Which was the most popular college choice among students from Princeton Day School, Class of 1999? 	ORGANIZATION
How many registered Internet domain names are there worldwide? 	AMOUNT
What percentage of Princeton High graduates will be attending Ivy League schools in the fall? 	PERCENTAGE
How many people are victimized by landmines each year? 	AMOUNT
Which is the most common reportable, communicable disease in New Jersey? 	OTHER
Rutgers is the most popular college choice among this year's graduates at West Windsor-Plainsboro High School. Which college is the runnerup? 	ORGANIZATION
How many nuclear weapons are there in the world today?	AMOUNT
What will the annual tuition be for New Jersey students attending Rutgers in 1999-2000? 	MONEY
How much does the average black American spend annually on lottery tickets? 	MONEY
When did New Jersey public television first go on the air? 	TIMEPOINT
What percentage of donations to colleges and universities comes from alumni? 	PERCENTAGE
Which nation's government is considered the least corrupt in the world? 	LOCATION
What percentage of Major League baseball players are from the Caribbean or Latin America? 	PERCENTAGE
Which college will enroll the most students from The Lawrenceville School's Class of 1999 this fall?	ORGANIZATION
What percentage of federal prisoners are incarcerated for non-violent drug offenses?	PERCENTAGE
Which state has the highest per-pupil expenditure for public schools?	LOCATION
Which national Internet news site has the largest audience share? 	OTHER
What is the official New Jersey state shell? 	OTHER
How many state police patrol the N.J. Turnpike? 	AMOUNT
Which living philanthropist has given the most money to charitable causes?	PERSON
Just days before Bill Bradley entered Princeton University as a freshman, he had intended to enroll at which university?	ORGANIZATION
What was the most frequently diagnosed and/or treated cancer at the Hunterdon Medical Center in 1997?	OTHER
What percentage of Americans think their financial situation is the same or better than it was last year?	PERCENTAGE
Which popular music act's single had the most radio air play in 1980? 	OTHER
How many casualties were there in the Battle of Verdun during World War I? 	AMOUNT
How many nations have been bombed by the U.S. military in the past eight months?	AMOUNT
Which country is projected to have the largest population in the year 2030? 	LOCATION
What is the hottest temperature ever recorded in May in New Brunswick?	AMOUNT
For a family of four in New Jersey, what is the maximum amount of income that is exempt from the state income tax?	MONEY
What is the median age at the time of marriage for grooms in New Jersey? 	Y
Which casino in Atlantic City generated the most gambling revenue during the past year? 	OTHER
Which is the youngest county in New Jersey? 	LOCATION
Which state has the strictest disclosure laws for legislators? 	LOCATION
What is the world's busiest airport, measured by number of passengers?	OTHER
Which golf resort was rated best in the world by Conde Nast Traveler readers? 	OTHER
Which state had the highest rate of bankruptcy filings last year? 	LOCATION
What is the New Jersey state insect?	OTHER
What is the annual cost of membership to the Ivy Club, an eating club at Princeton University? 	MONEY
Which town in America has the most expensive housing? 	LOCATION
Which country has the highest per-capita Internet usage? 	LOCATION
What was the top renting video of 1998? 	TITLE
What is the most popular major among Princeton University sophomores?	OTHER
What percentage of the world's nations have a free press?	PERCENTAGE
In 1996, 9,390 Americans were murdered with handguns. How many Canadians were killed with firearms in that same year?	AMOUNT
What percentage of stocks and mutual funds is owned by the wealthiest 10 percent of households?	PERCENTAGE
Which U.S. president officially proclaimed Mother's Day a national holiday? 	PERSON
What was the largest one-year return on a stock mutual fund during the past year? 	MONEY
How many New Jersey residents have been diagnosed with HIV/AIDS? 	AMOUNT
How many countries in which citizens are not allowed to choose their leaders democratically received arms shipments from the U.S. government in 1997?	AMOUNT
What is the cost to airlines of the average food serving on a domestic flight?	MONEY
Which county in New Jersey has the smallest land area?	LOCATION
What percentage of the members of the Princeton University class of 2002 were recruited athletes? 	PERCENTAGE
Among female retirees, what percentage of their income comes from personal savings? 	PERCENTAGE
In which year was the homicide rate in the United States the highest?	TIMEPOINT
How many men from Mercer County lost their lives in the Vietnam War?	AMOUNT
What percentage of daily newspaper readers in New Jersey read newspapers owned by either Gannett or Newhouse (Advance Publications)?	PERCENTAGE
How much will season tickets cost for the Princeton University football team's six home games this fall?	MONEY
In 1990, 931,000 sport utility vans were sold in the United States. How many were sold last year?	AMOUNT
What percentage of U.S. households are online? 	PERCENTAGE
What is the average salary of a full professor at Princeton University? 	MONEY
What are the odds of a child being killed by gun violence at school?	PERCENTAGE
On average, about how often is the air quality in New Jersey deemed "unhealthy" by the state Department of Environmental Protection?	PERCENTAGE
Which restaurant was rated the top "eclectic" in New Jersey by Zagat?	ORGANIZATION
When was the last time an American won the men's race in the Boston Marathon?	TIMEPOINT
How many Americans have smoked marijuana at some point in their lives?	AMOUNT
How many interchanges are there on the New Jersey Turnpike? 	AMOUNT
What is the most densely populated county in New Jersey. 	LOCATION
What was the average starting salary for 1998 Princeton University graduates? 	MONEY
What is the most popular name for boys in New Jersey? 	PERSON
What was the average pay for CEOs at 365 of the largest companies in the nation last year?	MONEY
Which New Jersey county had the fewest fatal auto accidents in 1997?	LOCATION
What is the record for most rain in a single spring day in New Brunswick?	DISTANCE
What percentage of voters in the top income quintile voted in the 1998 Congressional elections?	PERCENTAGE
What percentage of applicants who are accepted at Princeton University end up enrolling there?	PERCENTAGE
What percentage of males with college degrees work more than 50 hours a week?	PERCENTAGE
In which of the IRS's 33 districts are the odds of someone with a total income of more than $100,000 a year being audited the lowest?	LOCATION
What percentage of persons entering U.S. prisons and jails have been sentenced for non-violent crimes?	PERCENTAGE
What is the earliest date in the year Easter has been celebrated during the past century? 	TIMEPOINT
Which school district in Mercer County has the highest median teacher salary? 	LOCATION
Which college was rated "Most Wired" by Yahoo! magazine?	ORGANIZATION
How much are jurors paid for each day of service? 	MONEY
What percentage of radio stations in the U.S. have had a change in ownership during the past three years? 	PERCENTAGE
What was the average car insurance bill for New Jersey drivers in 1997? 	MONEY
Which company fared best in Business Week's 1999 "Performance Rankings"? 	ORGANIZATION
About how many years did it take for New Jersey's population to double from 4 million to approximately 8 million today? 	DURATION
How much did total spending in municipal elections in New Jersey increase or decrease between 1990 and 1997? 	MONEY
In how many different languages is the written driving test for a New Jersey license available? 	AMOUNT
What country is Kosovo's neighbor to the south?	LOCATION
How many stocks were included in the original Dow Jones industrial average?	AMOUNT
What percentage of the revenue derived from the federal personal income tax in 1997 was paid by the wealthiest 1.5 percent of taxpayers? 	PERCENTAGE
Which New Jersey high school had the highest composite, top-quartile SAT score in 1997-98?	ORGANIZATION
What percentage of published studies about new drugs that are financially supported by the pharmaceutical industry comment favorably on the drug?	PERCENTAGE
Today marks the first day of spring, the vernal equinox. What is an equinox?	DESCRIPTION
What is the architectural style of the home Albert Einstein once lived in at 112 Mercer St., Princeton? 	OTHER
Which make of automobile has the most models included on Consumer Reports' "Used Cars To Avoid" list?	OTHER
Where was St. Patrick born?	LOCATION
What is the March single-day record for most snowfall in New Brunswick?	DISTANCE
What percentage of households making under $10,000 a year have credit cards?	PERCENTAGE
What is the Princeton basketball team's all-time winning percentage against N.C. State, its opponent in Monday night's NIT game? 	PERCENTAGE
What was the fastest-growing county in New Jersey between July 1997 and July 1998? 	LOCATION
Which school district in Mercer County has the highest per-pupil costs?	LOCATION
Which hospital in New Jersey performed the most coronary artery bypass operations in 1996-97?	ORGANIZATION
Adjusted for inflation, how much has the average salary of a college professor risen or fallen during the past 25 years? 	MONEY
What is the record low temperature for a March day in New Brunswick? 	AMOUNT
What percentage of students polled at Princeton High School said they had never cheated on a test or quiz?	PERCENTAGE
Which county in New Jersey has the highest cancer rates? 	LOCATION
Which state attracts the most overseas visitors? 	LOCATION
Which school district had the highest HSPT scores in New Jersey in 1997-98?	LOCATION
What is the annual salary of a major in the Army with 12 years of service? 	MONEY
What percentage of students at Penn and Columbia are either Asian or Jewish? 	PERCENTAGE
Which of the following reportable diseases was most common in New Jersey in 1997? 	OTHER
Bill Gates' net worth is equal to that of the combined total of how many Americans? 	AMOUNT
Which school has had the most individual Ivy League basketball scoring champions over the past three decades? 	ORGANIZATION
What sport results in the most emergency room visits? 	OTHER
What percentage of incumbents for U.S. House seats won re-election last fall? 	PERCENTAGE
Which is the nation's wealthiest foundation?	ORGANIZATION
What percentage of U.S. households own their own home?	PERCENTAGE
In what year was the first eating club built at Princeton University?	TIMEPOINT
What percentage of women report having had sexual relations with a person other than their spouse, while married?	PERCENTAGE
Which county in New Jersey has the most horses?	LOCATION
How many police officers in New Jersey have been killed in the line of duty over the past 10 years?	AMOUNT
On average, women spend 15.6 hours per week on housework. How many hours do men devote to housework? 	DURATION
What percentage of 1997 female high school graduates enrolled in college? 	PERCENTAGE
What is the record high temperature for a February day in New Brunswick?	AMOUNT
How did St. Valentine, the holiday's namesake, die? 	OTHER
In 1996, the net worth of Gordon Wu, a Princeton alumnus who pledged a donation of $100 million to the university a few years ago, was $1.2 billion. What is his net worth today? 	MONEY
A study by a psychology student found that 30 percent of couples on the Princeton University campus were interracial. What percentage of those relationships involved whites and blacks? 	PERCENTAGE
Which New Jersey daily newspaper lost the most circulation, in percentage terms, between 1990 and 1998? 	OTHER
What percentage of the state's HMO market will Aetna U.S. Healthcare control if the Justice Department approves its purchase of Prudential Healthcare? 	PERCENTAGE
Which bank has the most branches in New Jersey? 	ORGANIZATION
Other than gym, what class do Princeton High School students cut most often? 	OTHER
How many U.S. stocks lost value in 1998? 	AMOUNT
Which New Jersey high school had the highest combined SAT scores in 1997-98? 	ORGANIZATION
Which Ivy League team has gone the longest without beating Princeton in basketball? 	ORGANIZATION
What percentage of milk and dairy products consumed in New Jersey is produced by New Jersey farmers? 	PERCENTAGE
Which U.S. air carrier had the lowest rate of consumer complaints lodged against it in 1998?	ORGANIZATION
What portion of the 10 percent federal tax cut proposed by Republicans would go to the wealthiest 10 percent of taxpayers? 	PERCENTAGE
How many domestic violence offenses were committed in New Jersey in 1997 by persons who had court restraining orders issued against them? 	AMOUNT
How many rail stations does NJ Transit operate? 	AMOUNT
Which Ivy League school charges the most for tuition and room and board? 	ORGANIZATION
What is the error rate of paper tax returns submitted to the IRS? 	PERCENTAGE
Where did Richard Stockton, the founder of the Stockton family in America, first settle after leaving England? 	LOCATION
Which brand of big-screen TV (31-36 inch) has the worst repair history?	ORGANIZATION
How much money could you save each year if you carpooled to work, rather than driving alone, based on a 40-mile, round-trip daily commute and a car that gets 25 mpg?	MONEY
How much did the average, inflation-adjusted earnings of the bottom fifth of male workers increase or decrease between 1979 and 1996?	MONEY
When was the last time the Princeton University men's ice hockey team won the Ivy League title?	TIMEPOINT
What is the primary design element on the Princeton University Senior Jacket Committee's choice for the Class of '99 jacket?	OTHER
Who was the first popularly elected governor in New Jersey?	PERSON
What's the single-game Ivy League record for rebounding by one player?	AMOUNT
What percentage of college students reported engaging in binge drinking - consuming at least four drinks in a row - at least once during the two-week period prior to being surveyed?	PERCENTAGE
In what year was Alexander Hall on the Princeton University campus completed?	TIMEPOINT
How many municipalities are named "Washington" in New Jersey? 	AMOUNT
How many people have active real estate licenses in New Jersey? 	AMOUNT
How many millionaires were there in New Jersey in 1996? 	AMOUNT
In what year did McCarter officially become an independent theater? 	TIMEPOINT
How many times greater is the pay of the average CEO than that of the average worker? 	AMOUNT
What percentage of women in New Jersey 40 years and over have never had a mammogram? 	PERCENTAGE
What was the last Ivy League team other than Penn to beat Princeton in basketball? 	ORGANIZATION
Which automobile moving violation in New Jersey carries the most points?	OTHER
How many of the dozen people on the New Jersey State Police "12 Most Wanted" list are women?	AMOUNT
What percentage of candidates passed the New Jersey State Bar Exam in July 1998?	PERCENTAGE
Which stock had the best year in 1998?	OTHER
What is the largest amount of snow that has fallen in a single day in January in central Jersey?	DISTANCE
New Jersey's 566 municipalities are, on average, the smallest in the nation. Which state ranks second?	LOCATION
How much did holiday-season retail sales increase this year over last in New Jersey?	MONEY
What percentage of drunken drivers involved in fatal accidents are chronic, problem drinkers?	PERCENTAGE
What was the top grossing movie of 1998? 	TITLE
How many states have a lower blood alcohol level standard for drunken driving than New Jersey?	AMOUNT
When is the last time the Princeton University men's basketball team lost three games in arow?	TIMEPOINT
What is the lowest rent for an apartment listed in an apartment shopper's guide for Mercer, Middlesex and Somerset counties?	MONEY
Who was the original owner of Prospect House on the Princeton University campus?	PERSON
What are the names of the Three Kings?	PERSON
Which popular Christmas song was actually written for Thanksgiving?	TITLE
What was the original name of the Hun School? 	OTHER
What are the odds of snow falling on Christmas Day in central Jersey?	OTHER
In 1996, what percentage of teen-age girls with a baby had a second child? 	PERCENTAGE
What is Gov. Christie Whitman's salary this year? 	MONEY
Which homeowners insurance company received the highest rating from subscribers to Consumer Reports? 	ORGANIZATION
In what year during the past 25 were the most murders committed in New Jersey? 	TIMEPOINT
Which war involved the largest number of American troops? 	OTHER
What is the earliest in the season that more than a half inch of snow has fallen in New Brunswick?	OTHER
Who was the largest contributor to the campaign of Carl Mayer of Princeton Township in the recent 6th District Congressional race?	PERSON
What percentage of foreign students enrolled in U.S. colleges and universities are from Asia?	PERCENTAGE
What percentage of the newly created jobs in New Jersey pay less than a living wage, defined as $37,931 for a family of four?	PERCENTAGE
What is the fewest points the Princeton University basketball team has allowed an opponent in a game since World War II?	AMOUNT
How many days was the N.J. State Senate in session last year? 	AMOUNT
How many Nike T-shirts does the average worker produce at the plant in San Bartolo, El Salvador, each day?	AMOUNT
What is the shortest interval this year in which the same Pick-3 lottery number won?	DURATION
Which restaurant listed in the 1998 Zagat survey received the lowest rating for decor?	ORGANIZATION
How many years this century have the Democrats controlled both houses of the state Legislature? 	AMOUNT
What is the U.S. record, in inches, for most snowfall in a single storm?	DISTANCE
What is the Princeton University basketball record for widest margin of victory in a game? 	AMOUNT
What was the population of U.S. prisons and jails in 1996? 	AMOUNT
When was Princeton Golf Club, later renamed Springdale Golf Club, formed? 	TIMEPOINT
What percentage of officers at the largest corporations are women? 	PERCENTAGE
How many flights were there last year at Newark Airport? 	AMOUNT
What percentage of motorists searched by the Maryland State Police on I-95 in 1996 were black? 	PERCENTAGE
How many snowstorms is the Farmer's Almanac predicting for this winter in New Jersey? 	AMOUNT
When is the last time the Princeton University basketball team lost to Monmouth University, its opponent on Saturday night? 	TIMEPOINT
Under what president did Thanksgiving begin to be celebrated the last Thursday of November?	PERSON
What percentage of graduates of the Princeton University Class of 1928 reported taking jobs in business soon after getting their degree?	PERCENTAGE
Who was the Baby Ruth candy bar named after?	PERSON
Which age group in the U.S. has the highest suicide rate? 	Y
Which rock 'n' roll act organized the first Horde Festival eights years ago. 	ORGANIZATION
Since 1971, how many members of Congress have been convicted of crimes and gone to prison?	AMOUNT
When is the last time Lafayette, the Princeton University basketball team's opponent in tonight's season opener, lost to the Tigers by less than 15 points?	TIMEPOINT
Which New Jersey restaurant received the highest rating for service in the 1999 Zagat Survey?	ORGANIZATION
Which major U.S. air carrier received the most complaints about mishandled baggage during the first nine months of this year?	ORGANIZATION
What was the largest fine meted out by the state to a nursing home in New Jersey for violation of health regulations during the first six months of this year?	MONEY
How many times during the past 30 years has any team other than Princeton or Penn won the Ivy League basketball title?	AMOUNT
In 1976, the richest 10 percent of Americans owned 19 percent of U.S. assets. What percentage did the richest 10 percent own in 1996?	PERCENTAGE
Which of the 1997, four-door sedans has the highest trade-in value at 15,000 miles?	OTHER
How many degrees separated the average weekly temperature at the New Jersey weather monitoring stations reporting the highest and the lowest averages?	AMOUNT
Which county in New Jersey had the lowest estimated unemployment rate in September?	LOCATION
What percentage of reported auto thefts in New Jersey result in arrests?	PERCENTAGE
Which Ivy League team has won the most championships in football? 	ORGANIZATION
Which category has the most listings in the Yellow Pages of the Princeton-Suburban Trenton phone book? 	OTHER
Which national chain of department stores received the highest overall rating from readers of Consumer Reports? 	ORGANIZATION
Of 163 countries surveyed, where did the U.S. rank in voter turnout in national legislative elections?	AMOUNT
Who holds the record for receiving the highest percentage of total votes cast in a New Jersey gubernatorial election?	PERSON
Which county in New Jersey had the lowest rate of assaults on police officers last year?	LOCATION
Which Ivy League school has gone the longest without winning a championship in football?	ORGANIZATION
What was the lowest voter turnout for an election in Princeton Borough during the past 20 years? 	PERCENTAGE
How much did Princeton University President Harold Shapiro earn in salary and benefits in 1996-97?	MONEY
During the past few 50 years, there have been 10 state referendum questions asking voters to approve the sale of bonds for the acquisition of farmland and open space. How many times have the questions been defeated? 	AMOUNT
What percentage of families in New Jersey have three children or more under the age of 18?	PERCENTAGE
What is New Jersey's state tree?	OTHER
In what year was the Ivy League founded? 	TIMEPOINT
How many acres of farmland in New Jersey were abandoned last year due to crop damage caused by deer? 	AMOUNT
What percentage of Princeton High School students worked during the summer?	PERCENTAGE
What percentage of respondents to a PC Magazine Online poll said they typically begin their Web searches at either Yahoo! or Alta Vista?	PERCENTAGE
What percentage of registered voters in the 12th Congressional District are Republicans?	PERCENTAGE
Which stock has performed the best during the past 12 months?	ORGANIZATION
The federal minimum wage, $5.15 an hour, totals $10,712 a year. What is the poverty line for a family of three? 	MONEY
How many touchdown passes did former Princeton University quarterback Jason Garrett, now with the Dallas Cowboys, throw in his best year at Princeton?	AMOUNT
What percentage of Americans visited a library at least once last year?	PERCENTAGE
Which state has the highest incidence of Lyme Disease?	LOCATION
How much has the monetary amount of the Nobel Prize increased over the past 10 years?	MONEY
Who said the following: "Few are those who see with their own eyes and feel with their own hearts."	PERSON
What was the median annual pay package for 1998 M.B.A. graduates from the top 25 business schools?	MONEY
Who made the largest-ever single donation of land to Princeton University?	PERSON
What is the Princeton University football team record for most consecutive games without a loss at home? 	AMOUNT
Princeton University freshman Kush Parmar is one of two Advanced Placement scholars invited to address an audience of educators next month in Orlando. On how many A.P. exams did he receive perfect scores? 	AMOUNT
What is the average monthly rent for a two-bedroom apartment in Middlesex, Somerset and Hunterdon counties?	MONEY
Name one of the top five contributors to Rep. Mike Pappas' re-election campaign?	PERSON
How many coffee trees are required to accommodate someone who drinks two cups of coffee a day for a year?	AMOUNT
How much has the value of Merrill Lynch stock fallen since its high in mid-July?	MONEY
What percentage of small businesses offers health care benefits to employees?	PERCENTAGE
During the past three decades, how many years have Republicans controlled the state Assembly in New Jersey?	DURATION
How many years has Newark Airport been in operation? 	AMOUNT
Which restaurant received the lowest rating for food in the 1998 Zagat Survey for New Jersey? 	ORGANIZATION
What percentage of consumer spending does the most affluent 20 percent of nations account for?	PERCENTAGE
In the Michelin Green Guide for New York, New Jersey and Pennsylvania, just one featured town in New Jersey, Cape May, received three stars. What was the only town to receive two stars?	LOCATION
Which category of crime had the largest increase in arrests during the past decade in New Jersey?	OTHER
Which elective offices had the largest increase in campaign spending in New Jersey over the past decade? 	OTHER
What percentage of clothing apparel sold in Wal-Mart stores is made in the United States? 	PERCENTAGE
Which medical specialty has the most listings in the Yellow Pages of the phone book?	OTHER
What age group accounted for the most fatal auto accidents in New Jersey last year?	Y
What is the Ivy League record for most points scored by one team in a game? 	AMOUNT
A statewide apartment hunters' guide lists about 170 complexes. In what town is the most expensive 1-bedroom apartment listed in the guide located?	LOCATION
Which fast food sandwich has the most grams of fat?	OTHER
How tall is the shortest 300-pound-plus football player in the Ivy League?	DISTANCE
Which of the public high schools ranked among the top 25 in the state by New Jersey Monthly magazine had the largest graduating class? 	ORGANIZATION
What percentage of male managers and supervisors work 46 hours a week or longer?	PERCENTAGE
Which county in New Jersey has the least amount of surface water, measured in square miles?	LOCATION
Which company in New Jersey was called "best for minorities" by Fortune magazine?	ORGANIZATION
Which Ivy League school pays its full professors the most?  	ORGANIZATION
Which writers have lived on College Road in Princeton?	PERSON
Median household income in the U.S. rose 6.3 percent between 1969 and 1996. How much did it increase for households above the median? 	PERCENTAGE
What is the record for most rainfall in a single day in New Brunswick? 	DISTANCE
How many states have a higher cancer mortality rate than New Jersey?	AMOUNT
During the past 10 years, 28 statewide referendum questions have appeared on the ballot. How many have been approved? 	AMOUNT
How much has crime risen, or fallen, in New Jersey's six largest cities over the past decade?	PERCENTAGE
Which airport had the highest percentage of delayed arriving flights in July?	ORGANIZATION
Which noted personality did NOT graduate from a high school in Mercer, Somerset or Middlesex County?	PERSON
What is the fastest scheduled time for a NJ Transit train from Princeton Junction to Penn Station in New York?	DURATION
Which of the company best weathered last week's stock market slide?	ORGANIZATION
Which state college in New Jersey had the largest percentage increase in tuition during the past 10 years?	ORGANIZATION
Which member of Congress from New Jersey received the lowest marks on the Public Interest Research Group's (PIRG) 1998 Report Card? 	PERSON
The Princeton University football team has played its three non-conference opponents for the upcoming season - Lehigh, Lafayette and Fordham - a total of 86 times. How many of those games has Princeton lost? 	AMOUNT
Which shopping mall in New Jersey has the most stores? 	ORGANIZATION
A state road sign on Nassau Street (Route 27), Princeton, lists three towns and the distances in miles to each of them. Two of the towns are Newark and New Brunswick. What is the third?	LOCATION
What percentage of employers disclose 401(k) investment or administrative fees to their participants?	PERCENTAGE
What was Witherspoon Street in Princeton called in the early years of the 19th century?	OTHER
Which town in Mercer County had the highest average commuting time of residents in the last Census?	LOCATION
Which Ivy League school did not make this year's U.S. News & World Report's Top 10 list of best universities in the nation? 	ORGANIZATION
How much did tobacco heiress Doris Duke of Hillsborough bequeath her dog Minni?	MONEY
Which is the final entry in the white page listings of the Princeton-Suburban Trenton phonebook?	OTHER
Which town in Mercer County had the most reported bias crimes last year?	LOCATION
Which U.S. town has the highest elevation? 	LOCATION
Which was the first of the Princeton University eating clubs to take up residence on Prospect Avenue?	ORGANIZATION
What is the state motto of New Jersey?	OTHER
What is the cost of a season ticket for the five Princeton University home football games this fall? 	MONEY
Which Princeton restaurant had the most improved ratings in the 1999 Zagat Survey? 	ORGANIZATION
Which county in New Jersey releases the most toxic chemicals into the air, water and land? 	LOCATION
What town in Mercer County has the largest percentage of residents more than 65 years of age?	LOCATION
Which book did Nobel Prize-winner Thomas Mann complete during his 2 1/2 years in Princeton?	TITLE
If the No. 600 NJ Transit bus is running on schedule, how long does it take to get from Forrestal Village in Plainsboro to the Trenton Rail Station if it leaves at 3:15 p.m.?	DURATION
How often is the Princeton Alumni Weekly published? 	DURATION
Who was the first governor to occupy Morven in Princeton under state ownership?	PERSON
Which town has the least amount of annual rainfall in New Jersey?	LOCATION
Which municipality in Mercer County had the fewest number of reported domestic violence incidents in 1996?	LOCATION
How did June Fletcher, Princeton University Class of 1973, gain national prominence?	OTHER
Which was the fastest-growing town in Mercer County between 1970 and 1994?	LOCATION
What percentage of women responding to a Harris Poll question about the fairness of divorce property settlements responded, "I received too much."	PERCENTAGE
What is the English translation of Princeton University's motto: "Dei Sub Numine Viget"?	OTHER
Who persuaded Andrew Carnegie to finance the construction of a dam needed to create the 3.5-mile-long Carnegie Lake.	PERSON
Which region of the country has the highest gas prices?	LOCATION
What's the difference in annual principal and interest between a 7 percent, 30-year, $100,000 fixed rate mortgage and an 8 percent mortgage of the same term and amount?	MONEY
During the 1990s, what percentage of all significant new drugs approved by the federal Food and Drug Administration have come from New Jersey?	PERCENTAGE
Where did Albert Einstein live in Princeton prior to moving to 112 Mercer St.?	LOCATION
Prior to the completion of Nassau Hall in Princeton in 1756, the trustees of the college had voted to name it after which person?	PERSON
Which colleges and universities in New Jersey has the lowest percentage of females enrolled?	ORGANIZATION
What is the leading cause of death in the 25-44 year-old age group in New Jersey?	OTHER
What is the longest public golf course in New Jersey?	ORGANIZATION
At a Democratic campaign training session for New Jersey officials last week, a political media consultant told the audience to focus on the three "P's." What are they? 	OTHER
Which companies had the best stock market performance since Jan. 1?	ORGANIZATION
How many Ivy League football championships has Princeton University won outright in the past 30 years?	AMOUNT
What percentage of businesses surveyed in New Jersey said they believed high schools were doing an above-average job of preparing students for the workplace?	PERCENTAGE
Where did Princeton University hold its commencements during most of the 19th Century?	LOCATION
Which of Mercer County's 13 municipalities has the population with the oldest median age?	LOCATION
How many hotel rooms and suites are there in Somerset County? 	AMOUNT
When executives are fired, what percentage of the time is it for incompetence?	PERCENTAGE
What is the official state dinosaur of New Jersey? 	OTHER
What percentage of reported auto thefts in New Jersey results in arrests?	PERCENTAGE
How many people have been killed by earthquakes in New Jersey during the past 300 years?	AMOUNT
Which New Jersey restaurant received the highest rating for decor in the 1998 Zagat Survey?	ORGANIZATION
In a national housing affordability study of 75 cities and regions, where did Central Jersey rank? (75th is least affordable.) 	AMOUNT
Which New Jersey towns had the lowest percentage of blacks in the last Census count?	LOCATION
Which categories have the most listings in the Princeton-Suburban Trenton Area phone book?	OTHER
How many vehicles are expected to travel on the Garden State Parkway over the three-day Fourth of July weekend?	AMOUNT
What percentage of Americans believe free trade agreements have a beneficial effect on salaries? 	PERCENTAGE
When was the last time Rep. Michael Pappas' Web site was updated, according to the site's home page? 	TIMEPOINT
On a scale of 0 to 4 - 4 being an A - what was the average GPA (grade point average) of humanities students at Princeton University between 1992 and 1997? 	AMOUNT
Muriel van Orden Jennings was the first alumna of the Princeton Theological Seminary. In what year did she graduate?	TIMEPOINT
Which New Jersey county had the lowest rate of assaults on municipal police officers in 1996?	LOCATION
How many volumes were there in the Princeton University library at the time of the Civil War?	AMOUNT
What is the record for most goals by a team in a World Cup soccer match?	AMOUNT
Which municipality in New Jersey had the highest percentage of Asian residents in the last Census?	LOCATION
How old is the oldest player on the Somerset Patriots baseball team?	Y
Next to Rutgers, which college in New Jersey has the largest enrollment? 	ORGANIZATION
What former presidents of Princeton University were not graduates of Yale? 	PERSON
Which New Jersey native has had the most No. 1 records?	PERSON
Route 206 is known by four different names in Montgomery and Princeton. Which of the four does not appear on any of the street signs along Route 206?	OTHER
Which Ivy League school had the highest minority enrollment among freshmen in 1995?	ORGANIZATION
Which of the 1990, four-door sedans with 80,000 miles on it has the highest resale value in the Princeton area?	OTHER
What was the most popular name for baby girls last year in New Jersey?	PERSON
Eighteen members of the Princeton High School graduating class will be attending Rutgers in the fall. Which New Jersey college ranks second in the number of incoming freshmen from PHS? 	ORGANIZATION
What percentage of the people arrested for drunken driving in New Jersey in 1996 were women? 	PERCENTAGE
How many of the Lawrenceville School's 204 graduating seniors will be attending Ivy League colleges next fall? 	AMOUNT
What town has the lowest Zip Code number in New Jersey? 	LOCATION
When the Princeton Theological Seminary opened in 1812, how many students did it enroll?	AMOUNT
Which town in New Jersey had the highest median family income in the last Census?	LOCATION
Princeton University lacrosse teams have won five national championships in the 1990s. How many Ivy League titles did they win during the 1970s and 1980s?	AMOUNT
The first two scholars appointed as professors at the Institute for Advanced Study were Albert Einstein and whom?	PERSON
How much did Carl Mayer spend per vote in Tuesday's Democratic primary in the 12th Congressional District? 	MONEY
Which presidential election between 1824 and 1996 had the most lopsided popular vote in New Jersey?	OTHER
Which restaurants in Princeton received the highest rating for service in the 1998 Zagat Survey of New Jersey restaurants?	ORGANIZATION
How much did Princeton University pay for the 825-acre Forrestal tract and the 16 laboratory buildings that were housed on it?	MONEY
Who was the youngest person ever elected to serve as president of Princeton University? 	PERSON
Who was the only Republican to carry the 15th District in a statewide, presidential or U.S. Senate race in the past five years? 	PERSON
What was the peak year for violent crime in New Jersey over the past 30 years? 	TIMEPOINT
What percentage of tolls collected on the New Jersey Turnpike is generated by out-of-state traffic? 	PERCENTAGE
What was the percentage change in total compensation for CEOs of small firms - sales less than $15 million - in 1996? 	PERCENTAGE
Other than the U.S. and Canada, which country has the most students represented on the undergraduate student body at Princeton University. 	LOCATION
Who is the largest private employer in Mercer County? 	ORGANIZATION
There are 15 towns called Princeton in the United States. Which Princeton has the largest population?	LOCATION
How many American soldiers died on the battlefield during World Wars I and II, the Korean Conflict and the Vietnam War?	AMOUNT
During an average year, how many days are there with some precipitation - rain or snow - in New Jersey? 	DURATION
In the early part of the 20th Century, who was the occupant of the Lower Pyne Building, now occupied by Hamilton Jewelers, at the corner of Nassau and Witherspoon streets in Princeton Borough?	PERSON
What is the fine for exceeding the new 65 mph speed limit, which takes effect on 475 miles of controlled-access highways in New Jersey Tuesday, by 1 to 9 mph? 	MONEY
What is the cost per week of sending a son or daughter to Princeton University? 	MONEY
What percentage of companies in New Jersey pick up between 91 and 100 percent of the health care tab for employees' family coverage? 	PERCENTAGE
What percentage of American women polled reported having had extramarital sex within the past year? 	PERCENTAGE
What percentage of Princeton High School students polled said they thought the decision to lengthen the school day by 24 minutes this year was an "excellent" one? 	PERCENTAGE
Which county in New Jersey has the largest farms, measured in average acres per farm? 	LOCATION
Princeton University is the largest taxpayer in Princeton Township. Who is second?	ORGANIZATION
In percentage terms, which newspaper in New Jersey lost the most daily circulation between 1990 and 1997? 	ORGANIZATION
What town had the most expensive housing in New Jersey in 1996? 	LOCATION
Which eating club at Princeton University has the highest percentage of members that have tried marijuana? 	ORGANIZATION
Smith is the most frequently listed name in the Princeton-Suburban Trenton Area phonebook. What is the second most common name? 	PERSON
Which restaurant was rated the favorite in New Jersey in the 1998 Zagat Survey?	ORGANIZATION
Which town in central Jersey has the largest population?	LOCATION
New Jersey continues to have the highest auto insurance rates in the nation, with an average premium of $1,259 in 1996. Which state has the lowest rates?	LOCATION
If the stock market fell as far tomorrow as it did between 1929 and 1932, what would the Dow Jones Index be, based on Friday's close of 9,147? 	AMOUNT
During what decade in the 20th Century was the rate of growth in the New Jersey state budget the greatest? 	TIMEPOINT
Of the 1,087 members of the newly graduated Princeton University Class of 1996 responding to a survey, 71 said they planned to pursue studies in medicine. How many said they planned to attend graduate school for business?	AMOUNT
New Jersey's cancer rates are higher than the national averages for virtually every major type of cancer. Among white males in New Jersey, there is one exception. What is it?	OTHER
Since 1840, Essex County has been the most populous county in New Jersey in every Census count but 1900, 1910 and 1990. Which county had the largest population in 1800 and 1820?	LOCATION
Which school district in Mercer, Middlesex, Somerset and Hunterdon counties had the lowest voter turnout in last week's school electons?	LOCATION
Which state was the speaker referring to in the following quote? "We have a world-class transportation system in our state." 	LOCATION
Which town had the third lowest overall crime rate but the second highest violent crime rate among suburban municipalities in Mercer, Middlesex and Somerset counties in 1996?	LOCATION
What corporate CEO received the most compensation between 1995 and 1997?	PERSON
What percentage of Princeton University students polled by the student newspaper reported having had sexual intercourse "in their lifetime?"	PERCENTAGE
Which town in central Jersey is the largest geographically?	LOCATION
Why has the dollar weakened against the yen?	OTHER
How is I.Q. tested?	OTHER
Where is the St. Herman of Alaska Brotherhood located?	LOCATION
Where was the 1968 summer olympics held?	LOCATION
What Apollo mission was the first to circle the moon?	OTHER
What are the symptoms of Chronic Fatigue Syndrome?	OTHER
Who wrote the once and future king?	PERSON
Who is the first president of Turkey?	PERSON
What was the Second Great Awakening in religious history?	DESCRIPTION
Who was the seventeenth president of the United States?	PERSON
What virus spread in U.S. in 1968?	OTHER
What is the life span of a white tailed deer?	DURATION
What is ritialin made from?	OTHER
At what intensity does the human eye stop seeing light?	AMOUNT
What kind of tanks does Israel have?	OTHER
What are side effects of Claritin?	OTHER
What is the relationship of tv/computers and teen weightloss?	OTHER
What percentage of residential phones have call screening devices?	PERCENTAGE
How many farmers are there in the U.S. today?	AMOUNT
What is magnet therapy?	DESCRIPTION
What are some model railroad magazines?	TITLE
Who is Douglas Stuart?	PERSON
How much does Canada spend on NATO?	MONEY
Who is Matthew Hopkins?	PERSON
What is a felt maker called?	DESCRIPTION
Who is Harrison Ford?	DESCRIPTION
What is the ESA?	DEFINITION
Who is the world's number one golfer?	PERSON
What are some traditional anniversary gifts?	OTHER
Who wrote the poem called "Trees"?	PERSON
What is the cost of an ultralight plane in New Zealand?	MONEY
What route did Lewis and Clark take going west in 1804?	OTHER
What does FTP stand for?	DEFINITION
What is the best way to propagate rosemary?	OTHER
What is the average salary of a MCSE in Australia?	MONEY
What happened on January 29th, 1954?	OTHER
What is the average Body Mass Index (BMI) for teenage girls?	AMOUNT
Who was the eighth president of the United States?	PERSON
What does a buffalo look like?	OTHER
What is Ralph Steadman best known for?	DESCRIPTION
What is the average temperature in Tokyo?	AMOUNT
What percentage of the United States is mormon?	PERCENTAGE
How many people survived the Titanic?	AMOUNT
What are some ingredients for beef brisket?	OTHER
Who is Dionysius?	DESCRIPTION
Who wrote Oliver, the musical?	PERSON
How many Catholic churches are there in South Dakota?	AMOUNT
What sport do the Buffalo Bills play?	OTHER
What is MS DOS?	DEFINITION
Where can I go to renew my United Kingdom passport?	LOCATION
How many Appollo missions have there been?	AMOUNT
What is a sound sampler?	OTHER
What plays did William Mastrosimone write? 	TITLE
Who is the king of Belgium?	PERSON
What percentage of Amsterdam uses drugs?	PERCENTAGE
Who is Charles Chaplin?	DESCRIPTION
What are the symptoms of Candida Albicans? 	OTHER
What tools are used for electrolysis?	OTHER
What is sleep apnea?	DESCRIPTION
Where is Cuchulainn?	LOCATION
How old is the Pope?	Y
What is Huntington's chorea?	DESCRIPTION
When was the Yom Kipur War in Israel?	TIMEPOINT
When was the first silver dollar made?	TIMEPOINT
What is Tourette's syndrome?	DESCRIPTION
What is the population of Iowa?	AMOUNT
Who is James Taylor?	DESCRIPTION
How many calories are in a strawberry?	AMOUNT
What is the smallest fish?	OTHER
What are pins on computer hard drives?	OTHER
Who is Robert McCloskey?	DESCRIPTION
Who is Pierre Curie?	DESCRIPTION
What was the population of the United States in 1968?	AMOUNT
Who discovered pyroelectricity?	PERSON
Who was the father of rocketry? 	PERSON
Where is Naples, Italy?	LOCATION
What country causes the most pollution? 	LOCATION
What are the symptoms of poisoning in a child? 	OTHER
What were the treatments for arsenic poisoning in the 1840's?	OTHER
What are some native amercian customs and rituals? 	OTHER
Where were the Kiowa Indians located? 	LOCATION
How many cities are there in Poland?	AMOUNT
Who wrote the book, "Brave New World"?	PERSON
When was J. Crew founded?	TIMEPOINT
What is U2's latest album?	DESCRIPTION
What do Eastern Orthodox women wear? 	OTHER
Who is the president of El Salvador? 	PERSON
Where is the Saguaro National Monument? 	LOCATION
What is the population of Sydney?	AMOUNT
When did Ben Franklin invent bifocals?	TIMEPOINT
What is a steel mill?	DESCRIPTION
What is the cost of living in New Orleans? 	MONEY
Who is the actress that plays Dilann on Babylon 5?	PERSON
How many arabian horses are there in the United States? 	AMOUNT
What horse has won the most prize money in racing?	OTHER
What is the world's largest building?	OTHER
What diseases are tingling sensations in the limbs a symptom of?	OTHER
Where is James Cook University? 	LOCATION
What is the name of the japenese stock market? 	OTHER
What are supernovas?	DESCRIPTION
What should I feed an llama?	OTHER
Where were the 1998 Olympics?	LOCATION
What is the capital of Canada?	LOCATION
What are the effects of corrosion on the Eiffel Tower? 	OTHER
Who is a famous ballad writing poet? 	PERSON
What is the capital of Ghana?	LOCATION
How much does a Pentium II 233 MHz processor cost?	MONEY
How many rich people live in the US?	AMOUNT
What pills can you take to stop smoking?	OTHER
Who invented science fiction?	PERSON
Who is Mary Poppins?	DESCRIPTION
Who is the author of "Stranger in a Strange Land"?	PERSON
Who is Maya Angelou?	DESCRIPTION
What is the average salary of a librarian?	MONEY
How many calories are in one cup of skim milk?	AMOUNT
What is a grenade?	DESCRIPTION
Where is Bergen Beach?	LOCATION
How fast do bullets travel?	AMOUNT
Where is New York's 63rd precinct? 	LOCATION
What are car prices in Holland?	MONEY
How many people are there in the Senate?	AMOUNT
What year was golf invented?	TIMEPOINT
What are black holes?	DESCRIPTION
What is the Bermuda Triangle?	DESCRIPTION
What is Stonehenge?	DESCRIPTION
How many square meters are in one acre?	AMOUNT
Who is Bigfoot?	DESCRIPTION
At what age can I draw money out of a roth IRA?	Y
What is an optical illusion?	DESCRIPTION
What is the tallest mountain in the world?	OTHER
What did women wear during the American Revolution?	OTHER
How does mold grow?	OTHER
What does 20/20 vision mean?	OTHER
What is the climate like in Michigan?	OTHER
What kind of treatments are there for severe neck pain?	OTHER
What percentage of children living in poverty in Minnesota are Hispanic? 	PERCENTAGE
How many natural disasters were there in the United States in 1997?	AMOUNT
What are the hunting seasons in Pennsylvania?	OTHER
Who is the bishop of the diocese of Northern California? 	PERSON
What did Franklin D. Roosevelt do for the people in 1940?	OTHER
What are tendons?	DESCRIPTION
Who ran for president of the United States in 1940?	PERSON
What is criminology? 	DESCRIPTION
What is the unemployment rate in France?	PERCENTAGE
Who ran for governor of Minnesota in the 1998 general election?	PERSON
What is the unemployment insurance rate for the State of Georgia? 	PERCENTAGE
What does presidential censure entail? 	OTHER
How do you determine if a year is a leap year? 	OTHER
How do I define a music ontology? 	DESCRIPTION
How much do commercial jets sell for?	MONEY
What city is the phone number 651-578-3070 located in?	LOCATION
What is interesting to visit in Frankfurt?	OTHER
What was the Academy Award best picture in 1971?	TITLE
Who was the Grammy winner for best album in 1970?	PERSON
What does ASTM stand for?	DEFINITION
What was the price of gold in 1950?	MONEY
What are some side effects from getting a flu shot?	OTHER
What is the latitude of Rochester, New York?	AMOUNT
Which president is on the five dollar bill?	PERSON
What was the top K-12 school in the US in 1997?	OTHER
What was the fastest living organism that ever existed in the history of the Earth?	OTHER
Where is Wal-Mart headquarters?	LOCATION
What are the chemical properties of the metal gold?	OTHER
Which organizations are opposed to horror films?	ORGANIZATION
What is the legal age of consent?	Y
What is narcolepsy?	DESCRIPTION
What does ISP stand for?	DEFINITION
Who was the first prime minister of Britain?	PERSON
What is the nutritional value of oysters?	OTHER
What is the real name of writer, Domini Taylor?	OTHER
How many endangered species are there in the world?	AMOUNT
How far is New Delhi from Seattle?	DISTANCE
What is the most popular ski resort in the United States?	ORGANIZATION
Who was the President of the United States in 1998?	PERSON
When did the Internet begin?	TIMEPOINT
Who is the Austrailian Prime Minister?	PERSON
Where is the University of Shephard?	LOCATION
What are the the names of the three time zones in the United States?	OTHER
What is Denmark famous for?	OTHER
Who did Ridick Bowe refuse to fight?	PERSON
Who was elected mayor of Paris 1791?	PERSON
What is netiquette?	DESCRIPTION
What is the definition of molecular ovality?	DESCRIPTION
Who gave the opening speech at the 1992 Democratic National Convention?	PERSON
How many people received speeding tickets in 1998?	AMOUNT
What is the average cost of renting a house in Clinton, MA?	MONEY
What is the furthest planet from the Earth?	OTHER
Where is the American Lung Association of Minnesota?	LOCATION
What are the newspapers that have web pages in Laramie, Wyoming?	OTHER
Who wrote "A Clockwork Orange"?	PERSON
What is a tennis elbow?	DESCRIPTION
What is the best non-chemotherapy cure for a lymphoma? 	OTHER
What are the seven sister colleges?	ORGANIZATION
Name some causes of rashes on babies' cheeks.	OTHER
What is the phone number for the Bancroft Library at the University of California at Berkeley?	AMOUNT
Who invented the battery?	PERSON
When was the battery invented?	TIMEPOINT
What does the prefix cata mean in the English language?	DESCRIPTION
What is the market value of a beanie baby?	MONEY
How does alcohol affect the brain?	OTHER
What is the most popular breakfast food?	OTHER
Who said, "The only thing we have to fear is fear itself"?	PERSON
What is source code?	DESCRIPTION
What is the CIA?	DEFINITION
Who is Homer Simpson?	DESCRIPTION
When did James Madison die?	TIMEPOINT
Who is Phillis Wheatley?	DESCRIPTION
What role did Patrick Henry play in the Constitutional Convention?	OTHER
How old was Mercy Otis Warren during the Constitutional Convention?	AMOUNT
What are the harmful effects of epherdrine?	OTHER
Who are Chicago's top-rated ISPs?	OTHER
How high is Mount Everest?	DISTANCE
What is the age range for "generation X" people?	DURATION
When were the riots in Sri Lanka?	TIMEPOINT
What percentage of email clients are HTML-enabled?	PERCENTAGE
What car company makes the Lincon Continental?	ORGANIZATION
Name a food that contains melatonin.	OTHER
Where is the Washington DC National Airport located?	LOCATION
What immunizations do I need in order to travel to India?	OTHER
When was the Battle of Hastings?	TIMEPOINT
What motels in Utah allow pets?	OTHER
What is the area code for Portland,OR?	AMOUNT
Where did the band Silverchair originate from?	LOCATION
How many potatoes can fit in a wheelbarrow?	AMOUNT
When did tickets for the 1998 World Series go on sale?	TIMEPOINT
Where can I buy Cole Hahn shoes in New York City?	ORGANIZATION
How old was Selena when she died?	Y
What causes diabetes?	OTHER
How much does it cost to rent a car in Sweden?	MONEY
What is the second planet in our Solar System?	OTHER
What is the safest American car made today?	OTHER
How old was Jack Kennedy when he was elected President?	Y
How many employees are employed by Microsoft?	AMOUNT
Who directed the film "Straw Dogs"?	PERSON
Where is the world's largest roller coaster?	LOCATION
What countries made up the former USSR?	LOCATION
What was the first album that Michael Jackson released after his million dollar album, "Thriller"?	TITLE
What city is the zip code 90812?	LOCATION
Who is the main actor in "The Truman Show"?	PERSON
What is the distance from Regina, Saskatchewan to Winnipeg, Manitoba? 	DISTANCE
Why is Jean Arp a famous painter?	OTHER
Name a blood disorder that can cause bruising.	OTHER
Who is Arthur Miller?	DESCRIPTION
How many different kinds of doves are there?	AMOUNT
How much does it cost to build an intranet?	MONEY
How much do public schools spend per student?	MONEY
What is the name of Presient Clinton's dog?	OTHER
Who was the wife of the 15th president of the United States? 	PERSON
How much did a movie ticket cost in 1966?	MONEY
What is the distance to the moon?	DISTANCE
How many people died in the Vietnam War?	AMOUNT
What is a myth?	DESCRIPTION
What football team does quarterback Steve Young play for?	ORGANIZATION
Who is the richest man alive?	PERSON
What temperature should merot wine be served at?	AMOUNT
What is the function of the spleen?	OTHER
How much does one gallon of water weigh?	AMOUNT
Who were the British Prime Ministers under King George V?	PERSON
What were the names of the government agents that were killed in Waco, TX in 1993?	PERSON
What is the punishment for underage drinking in Maryland?	OTHER
What does nonpartisan mean?	DESCRIPTION
Where is the FBI headquarters located?	LOCATION
What North American river flows uphill?	OTHER
Name a play written by William Shakespeare.	TITLE
How much do surgeons get paid?	MONEY
Who invented the toaster?	PERSON
When was the first toaster invented?	TIMEPOINT
Who assassinated John F. Kennedy?	PERSON
Who started the Carnegie Mellon architecture program?	PERSON
What is plasma?	DESCRIPTION
Where is the Statue of Liberty?	LOCATION
What are the most popular radio stations in London?	ORGANIZATION
What does NASA stand for?	DEFINITION
Who is the president of Russia?	PERSON
What is one University in Turkey?	OTHER
What is the cost of a UK Television license?	MONEY
Where is the California Institute of the Arts?	LOCATION
Who was the first player traded to the Minnesota Twins during the baseball strike of 1994?	PERSON
What is Lenny Kravitz's favorite song by Jimi Hendrix?	TITLE
What kind of car does Jeff Gordon drive?	OTHER
Who are the leading manufactures of cranes?	ORGANIZATION
What is the salary of an armor truck employee? 	MONEY
What is the distance between Milwaukee and Pittsburgh? 	DISTANCE
How much does a drilling rig cost? 	MONEY
How do I treat a common wart?	OTHER
What effect does lithium have on sea urchin development?	OTHER
In what country is the Nile River located?	LOCATION
Where is the highest waterfall in the world?	LOCATION
What tv show was the young Marilyn Manson on?	TITLE
What are some ingredients for a pastrami sandwhich?	OTHER
What planet did the Odyssey space probe fly by?	OTHER
What is the population of Omaha, Neb.?	AMOUNT
Name one company that offers digital telephone service.	ORGANIZATION
What are some Australian slang words?	OTHER
What is the capital of Argentina?	LOCATION
What magazine compares consumer products?	OTHER
What is the most used letter in the alphabet?	OTHER
What color is the knife in the movie, "Scream"?	OTHER
What are some causes of depression?	OTHER
How many people live in the country of Japan?	AMOUNT
Who was the President of the US when televisions were invented?	PERSON
What is the name of one Hispanic poet?	PERSON
How often do you have to rotate tires?	DURATION
What is the cruise speed for a Cessna Skymaster?	AMOUNT
How many golf courses are there in Acapulco, Mexico?	AMOUNT
Who was the youngest graduate of a University ever?	PERSON
What are some of the chemicals in hair dye?	OTHER
Which Australian News channel has the highest ratings? 	ORGANIZATION
What is the wing speed velocity of an African sparrow?	AMOUNT
When did the popular food chain, Wendy's, first open?	TIMEPOINT
What are the stages of a developing egg?	OTHER
What are the symptoms of a gallbladder attack? 	OTHER
What were the treatments used for curing smallpox in the 1800's? 	OTHER
What happens when you evaporate sodium nitrate in water?	OTHER
What is the net worth of the NFL Eagles?	MONEY
Who directed the movie, "Undertow"?	PERSON
Which US supreme court justice said that no citizen should pay one penny more in taxes than necessary?	PERSON
What is a joint venture?	DESCRIPTION
What is the new area code for Minneapolis?	OTHER
What is the Earth's core made of?	OTHER
How many bones are there in the human body?	AMOUNT
How many students are enrolled at the University of Texas at Austin?	AMOUNT
What kind of food do wild bird's eat?	OTHER
How long is the Nile River?	DISTANCE
How long does it take to bake a potato?	DURATION
How many earthquakes occurred in Washington state in 1995?	AMOUNT
What is the air speed of a SR71 Blackbird? 	AMOUNT
How old was Ronald Reagan when he was elected president of the US?	Y
What new movie stars Julia Roberts as a stepmother and a model?	TITLE
How many points does it take to get a drivers license suspended? 	AMOUNT
How many registered voters are there in America? 	AMOUNT
When was the first video game invented?	TIMEPOINT
When did Richard Nixon die?	TIMEPOINT
What year was John F. Kennedy killed? 	TIMEPOINT
What animal did Hannibal use to fight against Rome? 	OTHER
How old did Winston Churchill live to be?	Y
What does Ontario law say regarding a tenant with a pet?	OTHER
How much money are old Mad Magazines worth?	MONEY
What is the average number of steps taken after running a mile?	AMOUNT
What are golden rectangles?	DESCRIPTION
How many bones are there in the human foot?	AMOUNT
How many countries are part of the United Nations?	AMOUNT
What day of the week did March 23, 1941 fall on?	OTHER
How many hours of sleep is recommended every night?	AMOUNT
What is catnip made of?	OTHER
Who are the most popular anime characters in Japan?	PERSON
What is the name of a book written by Samuel Clemens?	TITLE
What is the medication Eluxin used for? 	OTHER
What is the most common mineral?	OTHER
What are soft contact lenses made of?	OTHER
What were the conditions of the homefront in England during World War Two?	OTHER
What is the most common disease of the skin?	OTHER
Which player has hit the most homeruns in Major League Baseball?	PERSON
How many counties are there in Houston, Texas?	AMOUNT
What is flax made into after it is harvested? 	OTHER
How many people live in New York?	AMOUNT
What are some signs that a woman might be pregnant?	OTHER
How long does it take to boil an egg?	DURATION
What is the average income in North Adams, MA? 	MONEY
When would a squid need to change colors?	OTHER
How much education does someone need in order to become a plumber?	OTHER
Who invented the knife?	PERSON
What sort of sports did the Aztecs play?	OTHER
What day was November the ninth in the year 1995?	OTHER
What did Alexander Galt have to do with the confederation? 	OTHER
How long is the world's longest limousine?	DISTANCE
Who won the 1967 NLF championship game?	ORGANIZATION
Who paid the most for an NFL tem in 1994?	PERSON
In the comic strip "Doonesbury," who is the daughter of Boopsie and BD? 	PERSON
How much does a copyright cost in Canada?	MONEY
What was the first movie that Racquel Welch was in?	TITLE
What is gelatin made of?	OTHER
Who was Miss America in 1988?	PERSON
Why are anti-lock brakes a safety feature?	OTHER
When were anti-lock brakes invented?	TIMEPOINT
How many wives did Kubla Khan have? 	AMOUNT
What is a stratus cloud? 	DESCRIPTION
Who said: "A journey of a thousand miles begins with a single step"?	PERSON
What is an acropolis? 	DESCRIPTION
How many soldiers died in the Civil War?	AMOUNT
How much does the moon weigh?	AMOUNT
What is the retirement age of a schoolteacher?	AMOUNT
How did the banana split originate?	OTHER
What are the different parts of wheat?	OTHER
What is the second amendment in the US constitution?	DESCRIPTION
What was the first commercial use of computers? 	OTHER
What is a nonprofit agency for interracial families? 	ORGANIZATION
Who is the governor of Hawaii? 	PERSON
How many miles per hour is 1 knott?	AMOUNT
What is the name of the largest zoo in the United States?	OTHER
How many branches of McDonalds Restaurants are there in the UK?	AMOUNT
What are the most popular crimes committed by juveniles?	OTHER
When were airbags invented?	TIMEPOINT
What is the country code for the UK when calling from the US?	OTHER
Where did grafitti originate from? 	LOCATION
How does the National Endowment for the Arts recieve funding? 	OTHER
What is the latest medication used for the treatment of Rheumatoid Arthritis? 	OTHER
What herbs can increase my circulation? 	OTHER
What is the longest river in the United States?	OTHER
What company makes the drink Orangina?	ORGANIZATION
What is the diameter size of a golf ball? 	DISTANCE
Where is the Oakland airport?	LOCATION
Name one sports team (basketball, hockey, baseball, football, etc.) that is from New York.	ORGANIZATION
What are the US states that have the word "Island" in their name?	OTHER
What is a coeducational college? 	DESCRIPTION
Who served with the Ninth Marines between 1967 to 1968?	PERSON
What is the leading cause of death for motorcylclists? 	OTHER
How many albums have Insane Clown Posse made?	AMOUNT
How do I find my IP address?	OTHER
What instrument does Cedar Walton play? 	OTHER
How old is the United States? 	Y
What is the value, in dollars, of a 1993 Chevrolet Blazer?	MONEY
What is endometrosis? 	DESCRIPTION
What is the resaon that men's shirts button the opposite way of women's shirts? 	OTHER
What nascar driver was sponsored by underalls? 	PERSON
What company makes candy that have insects inside of it?	ORGANIZATION
Which star is the brightest?	OTHER
Name one food that contains zinc.	OTHER
What is the maximum recommended temperature for videotapes? 	AMOUNT
In the last year, how many police officers were shot with their own gun?	AMOUNT
How many group homes are there in Minnesota?	AMOUNT
What are the long term effects of cocaine use?	OTHER
What type of clothing did the Navajo Indians wear? 	OTHER
What is the Lutheran philosophy on being a good servant?	OTHER
What is the Latin word for Friend? 	OTHER
What is a life threatening food allergy?	OTHER
What purpose does the oxygen sensor in my car serve?	OTHER
Where can I go whale watching in California?	LOCATION
How does regeneration in starfish occur?	OTHER
Who was Britain's first Prime Minister?	PERSON
How many bones does a squirrel have?	AMOUNT
What is the average temperature in San Francisco, California?	AMOUNT
Who was Gerald Ford's Vice President?	PERSON
Who correctly theorized that mosquitoes cause yellow fever? 	PERSON
Who invented the paperclip? 	PERSON
Who invented the pencil? 	PERSON
What is a provisional patent? 	DESCRIPTION
What are the top preventive ways to avoid heart attack? 	OTHER
How do you remove water stains from yellow pine wood?	OTHER
What colleges in Michigan offer a master's degree in teaching writing? 	OTHER
What is a software watchdog? 	DESCRIPTION
What is the best Chemical Engineering School in the United States? 	OTHER
Who decides whether music contains explicit lyrics and needs a parent advisory label? 	OTHER
How much does a Besson Tenor trombone cost?	MONEY
What year were Egyptian hieroglyphics invented?	TIMEPOINT
Where in the United States is there the most violence committed by teens?	LOCATION
What is a company that makes products for the semiconductor industry?	ORGANIZATION
How much does a dental crown cost?	MONEY
Why are storm clouds black?	OTHER
Of all the planets in the solar system, which is the hottest? 	OTHER
Who had the longest field goal kick before Tom Dempsey?	PERSON
What is the cost of living in Asheville, NC? 	MONEY
How much would it cost to fly to Ireland from New York?	MONEY
Who invented the richter scale and what is it used for? 	OTHER
What is the Universal Declaration of Human Rights? 	DESCRIPTION
How long does marijuana stay in your system? 	DURATION
Name one scary ghost movie.	TITLE
What object is the only extragalactic star-forming nebula that can be seen with unaidedeye?	OTHER
Which commercial airline has the biggest seats? 	ORGANIZATION
What is the name of at least one woman in the World Wrestling Federation?	PERSON
How long was John Seiberling in Congress?	DURATION
What is the name of the current Miss America?	PERSON
Name one 17th century Dutch painter.	PERSON
When was the Canadian Privacy Act passed?	TIMEPOINT
How much does a Jack Russell Terrier weigh?	AMOUNT
How is a unicorn different from a horse?	OTHER
Where is the Eifel Tower? 	LOCATION
Who discovered oil in Pennsylvania? 	PERSON
What will be the average age of laborers in 2006?	Y
What are some high fiber foods?	OTHER
What country is the University of Queensland located in?	LOCATION
What are urban legends?	DESCRIPTION
What is the name of at least one Pharmaceutical Benefit Management Company?	ORGANIZATION
What was the name of the first feature film that was ever made?	TITLE
What was the name of the television show that Eric Stolz was in?	TITLE
How many people attend universities in France?	AMOUNT
How many different words do the Eskimos have for the word snow?	AMOUNT
What kinds of foods are made with flax?	OTHER
What is a company that makes customized dolls?	ORGANIZATION
What is the medical term for "lazy eye"?	OTHER
Who does the voice of Tony the Tiger?	PERSON
What is the top design school in New York?	OTHER
What is fingernail polish made out of?	OTHER
Where was Nicholas Evans, the author of "The Horse Whisperer," born?	LOCATION
What are radioactive minerals? 	DESCRIPTION
What are examples of some radioactive minerals? 	OTHER
What is the tallest tree in the world?	OTHER
Who is the smartest person in the world?	PERSON
Where can I rent ski equipment in New York?	LOCATION
Who wrote the arcade game name "Time Pilot"?	PERSON
Who is the most famous arcade game programmer?	PERSON
What holidays are in November? 	OTHER
In the fall, what do I need to cover strawberries in order to protect them?	OTHER
What time does the New York Stock Exchange close?	TIMEPOINT
What company makes mini DIN plug connectors? 	ORGANIZATION
What is the name of the oldest jail in Pennsylvania?	OTHER
Name a host from MTV's show, "The Grind."	PERSON
What are some animals that are unique to Australia?	OTHER
How old do you have to be in order to work in California?	Y
What year was Julio Iglesias born?	TIMEPOINT
What are some last minute halloween costumes for teenagers? 	OTHER
In what county is Berkeley, CA? 	OTHER
How many countries are there in the world? 	AMOUNT
Who composed the 1812 overture? 	PERSON
What is the real name of the bad news bears theme? 	OTHER
What were Pennsylvania's winning lottery numbers for Oct 24, 1998? 	OTHER
Who is Lynne E. Wilzbacher in Minnesota?	DESCRIPTION
What is the libertarian social security plan? 	DESCRIPTION
What day does Thanksgiving fall on this year?	OTHER
What chemicals are in Slate? 	TITLE
What is the drinking age in Canada?	Y
Who is the director of 1998's "Doctor Dolittle"?	PERSON
How many people died at the Alamo? 	AMOUNT
What is the best school of chemical engineering in the United States? 	OTHER
What is the average pc technician salary in phoenix?	MONEY
How old is the Empire State building in New York? 	Y
What city is Duquesne University in? 	LOCATION
How old was Jesus when he was killed? 	Y
What causes teeth infections in rodents? 	OTHER
What common household products remove stains? 	TITLE
What is the nutritional value of an apple?	TITLE
Name a state governor from 1962.	PERSON
Who has had the most wives known in history?	PERSON
What is the main reason people are discharged early from military service?	OTHER
What is the Latin word for "yes"?	OTHER
What is the name of the woman who gave birth live on the Internet? 	PERSON
Who discovered copper?	PERSON
What is the 1998 world population of bald eagles?	AMOUNT
Who painted the Sistine Chapel?	PERSON
Who designed the Statue of Liberty?	PERSON
Where in the world is there the most water pollution?	LOCATION
What is prolactin? 	DESCRIPTION
What bowel problems are associated with diabetes? 	OTHER
How many long distance carriers are there?	AMOUNT
How many bones are in the human ribcage? 	AMOUNT
Who is madonna's first husband? 	PERSON
What is known to be a successful treatment for lung cancer? 	OTHER
What was the reason Nova Xcotia didn't become the 14th colony?	OTHER
Who was the first Australian Prime Minister? 	PERSON
Who was the first person to climb Mt. Everest? 	PERSON
What does D.O.C.W.R.A. stand for? 	DEFINITION
Which paintings by David Teniers are in Ashmolean?	TITLE
What is a black box?	DESCRIPTION
What company produced the first video recorder put into use?	ORGANIZATION
What prescription medication can cause numbness in the face? 	OTHER
What scholarships are available for PhD students in Europe? 	OTHER
How much does uranium cost? 	MONEY
What is the world's most dangerous job?	OTHER
How many glasses of water should I drink each day? 	AMOUNT
What is the average hotel price in Sao Paulo Brazil? 	MONEY
When will Microsoft Office 2000 be released? 	TIMEPOINT
Where are my kidneys located?	OTHER
How much does a dollar bill weigh?	AMOUNT
How many bridges cross the missisippi river?	AMOUNT
How do I preserve a carved pumpkin? 	OTHER
What are some of the benefits from eating chocolate?	TITLE
Why does the South Carolina state flag have a crescent moon on it? 	OTHER
What is the average age that people get married?	Y
Who is Helen of Troy?	DESCRIPTION
Why do Jehovah's Witnesses not take blood transfusions?	OTHER
How do you cure enuresis? 	OTHER
Where can I go paragliding in the San Francisco Bay Area?	LOCATION
What is the ratio of males to females in the United States? 	AMOUNT
How long does it take to repair the lungs after giving up smoking? 	DURATION
How big is Donald Trump's yacht "The Trump Princess"? 	DISTANCE
What is Wolfe's Law?	DESCRIPTION
What is the average amount of money that a man carries in his wallet?	MONEY
What is the water temperature in Florida in November? 	AMOUNT
What U.S. state contains the counties of Macon and Bacon? 	LOCATION
What is counterculture?	DESCRIPTION
What type of halloween candy was purchased the most in 1997?	OTHER
What date will the moon be closest to earth in 1998?	TIMEPOINT
How many different kinds of plants are there?	AMOUNT
Name a plant that grows underwater.	OTHER
What country has the northernmost capital in the world? 	LOCATION
What is the main part of a plant called?	OTHER
Who was Thomas Hobbes?	DESCRIPTION
What are the four food groups?	OTHER
Who was the first woman to fly a helicopter indoors? 	PERSON
What is the fastest aircraft in the world? 	OTHER
How do I use a retort in chemistry? 	OTHER
How many different colors of lipstick are there?	AMOUNT
What is the percentage of teenage drug users? 	PERCENTAGE
How far is it from New York City to Providence, Rhode Island?	DISTANCE
How does a reverse osmosis water filter work? 	OTHER
How many times has a drag chute been deployed in a shuttle landing?	AMOUNT
How much does auto insurance cost for a guy in his late teens?	MONEY
What is the medical term for a charlie horse? 	OTHER
How many space flights have there been in U.S.? 	AMOUNT
What Bible software is available for Windows? 	OTHER
How many books are sold each year?	AMOUNT
How many copies of "The Pelican Brief" were published?	AMOUNT
What country can I find Ben Gurion University?	LOCATION
Who won the Stanley cup in 1993?	ORGANIZATION
How long will fresh pumpkin keep fresh if it is refrigerated?	DURATION
What is the name of the third book of Hitchhikers Guide to the Galaxy?	TITLE
How many different types of blood are there?	AMOUNT
What is the Supreme Court's definition of a religion? 	OTHER
What does it mean if my neutrophil count is high? 	OTHER
What year was the Declaration of Independence signed?	TIMEPOINT
Where is the best place to buy David Yurman jewelry? 	LOCATION
What does NIH stand for?	DEFINITION
What temperature should a sauna be? 	AMOUNT
What is dust mite?	DESCRIPTION
What herbs can cause seizures? 	OTHER
What planet is closest to the Sun?	OTHER
How old do you have to be in order to rent a car in North Carolina?	Y
What are the symptoms of fybromialgia? 	OTHER
Where is the movie, "Fargo," filmed?	LOCATION
Who is the biggest record selling artist of all time? 	PERSON
When was the Great Fire of London? 	TIMEPOINT
What was the date when the last Calvin and Hobbes comic strip was published?	TIMEPOINT
What are the most popular baby names?	OTHER
What Lulu Roman album is the song "Heaven's Watchin'" on?	TITLE
What religion is Madonna?	OTHER
What percent of the world's work is one by women?	PERCENTAGE
What is the diameter of the Earth?	DISTANCE
What was the name of Fred Flinstone's boss?	PERSON
How high can a plane fly?	DISTANCE
How tall does a dogwood tree grow?	DISTANCE
Tell me the name of a company in France that makes barrettes.	ORGANIZATION
How many months is allergy season in Cleveland, Ohio?	AMOUNT
What age do babies normally start to speak?	Y
Who killed John F. Kennedy?	PERSON
What was the name of Shakespeare's first play?	TITLE
What state has the highest Native American population?	LOCATION
What is the most commonly used currency in Europe?	OTHER
What was the year of the Hiroshima Bombing? 	TIMEPOINT
What is play-doh made from? 	OTHER
What is Microsoft's turnover rate? 	PERCENTAGE
What does serendipity mean? 	DESCRIPTION
When was the "Wizard of Oz" first released in the theaters?	TIMEPOINT
What are some foods that have low carbohydrates?	OTHER
When was the poem "Heritage," by Countee Cullen, written?	TIMEPOINT
What are some of the health benefits of Soy? 	OTHER
How much money do Minnesota public schools get from the federal government?	MONEY
What is the average weight of a whale?	AMOUNT
When did Seasame Street first air?	TIMEPOINT
What is the best food to eat if you have irritable bowel syndrome?	OTHER
Which insurance companies pay for disability after an automobile accident? 	ORGANIZATION
Where is the most expensive place to live in New York City?	LOCATION
Where is the Smithsonian Museum?	LOCATION
When did Leroy Anderson die?	TIMEPOINT
What does HTML mean?	DEFINITION
What actor got the first billing for the movie "The Fifth Element"?	PERSON
What is the new medicine for autistic children? 	OTHER
What percentage of children suffer from depression?	PERCENTAGE
What is the minimum age requirement to skydive?	Y
What state is Cleveland located in?	LOCATION
What is the number one cause of automobile accidents?	OTHER
Who authored the book, "Wuthering Heights"?	PERSON
How many years has the soap opera, "Another World," been on the air?	AMOUNT
How many people go on the Internet every day?	AMOUNT
When was the movie, "Meet Joe Black," first out in the theaters?	TIMEPOINT
What company offers the most frequent flyer miles when using their credit card?	ORGANIZATION
What medicines were used for curing smallpox in the Victorian era? 	OTHER
What ingredients do I need to make smoothies?	OTHER
How do I say "dog" in French?	OTHER
What kind of lodging is available in Aruba? 	OTHER
When was tea introduced to England?	TIMEPOINT
In how many countries has xenical been approved?	AMOUNT
How many minutes are there in a year?	AMOUNT
What is the difference between autobiography and biography? 	OTHER
What is the most addicting drug you can take?	OTHER
What is the mental and physical effects of caffine?	OTHER
How many students are enrolled at the University of Texas at Austin? 	AMOUNT
What do wild birds eat for food? 	OTHER
How long was the show, "Beverly Hills 90210" on the air?	DISTANCE
What was Glasgow University's main building originally designed to be?	OTHER
Who flew the first nonstop flight around the world?	PERSON
What number president was John F. Kennedy?	OTHER
How old did Vincent Van Gogh live to be?	Y
How many points does it take to get a drivers license suspended in Florida? 	AMOUNT
Who invented the first video game?	PERSON
What were Alexander Hamilton's political views? 	OTHER
What is a calzone?	DESCRIPTION
How much is a 1980 Mad Magazine worth?	MONEY
Who coined the phrase, "God is in the details"?	PERSON
What is the first line of the poem entitled "Rainbow Bridge"?	OTHER
How many years does a house of representive serve in a term?	AMOUNT
Who is one famous person who died of anorexia?	PERSON
What limousine company makes the longest limousine?	ORGANIZATION
How long is the world's longest limousine?	DISTANCE
What gift is given on the tenth anniversary?	OTHER
Name one song by Nine Inch Nails.	OTHER
What percentage of the United States has a fear of death?	PERCENTAGE
What is the name of Kate Chopin's most popular book?	TITLE
What Jeep has the best safety ratings?	TITLE
Where do wolves live?	LOCATION
What does GOP stand for?	DEFINITION
What are isopods?	DESCRIPTION
What show is Groundskeeper Willie a character on?	TITLE
What was the number one box office attraction this past weekend?	TITLE
What is a book written by Samuel Clemens?	TITLE
Who makes Netscape Communicator?	ORGANIZATION
What are utereine fibroids made of?	OTHER
What animal has more lives than a cat?	OTHER
What does darth mean? 	DESCRIPTION
Where was Woodstock 1999?	LOCATION
What happened in the first week in November 1981?	OTHER
What are some of the side effects of induced labor?	OTHER
What does OECD stand for?	DEFINITION
Who reads the news for BBC radio?	PERSON
What are some jobs for music majors?	OTHER
What is the most common mineral? 	OTHER
What is the name of McDonalds restaurant university? 	OTHER
What are soft contact lenses made of?	OTHER
What is forensic psychology? 	OTHER
What is the largest University in Washington DC?	OTHER
What is the address of the Archery Hall of Fame?	OTHER
Who composed the music for thr movie "The Rock"?	PERSON
What are the top three dog breeds in the United States?	OTHER
Who is Jeff Gordon? 	DESCRIPTION
What is the average salary of funeral directors?	MONEY
Who has hit the most homeruns in Major League Baseball?	PERSON
Who is "The Who"?	DESCRIPTION
Who wrote the rock opera "Tommy"?	PERSON
What is the name of a rural real estate company near College Station, Texas?	OTHER
What do birds use their beaks for?	OTHER
When were Morgan 3 Wheelers made?	TIMEPOINT
When did the NYC club, Tunnel, first open?	TIMEPOINT
How do I remove coffee stains from wood?	OTHER
What is the lowest price I can buy a DVD-ROM drive for?	MONEY
What is a school of squid?	OTHER
How many Bed and Breakfast places are there in Nashville?	AMOUNT
Which fruits and vegetables continue to ripen after picking?	OTHER
What religious groups believe that humans are from other worlds? 	OTHER
Who is the author of the book "A Kettle of Hawks"?	PERSON
What is Aspergers Syndrome? 	OTHER
"People are hungry not for food but for love."  Who said that? 	PERSON
How many girls names start with the letter d?	AMOUNT
Where is the New Salem Carriage Museum?	LOCATION
What is the theory of formalism in art 	OTHER
What percentage of Americans live in poverty?	PERCENTAGE
What city in the United States has the greatest annual rainfall?	LOCATION
What are some computer retail outlets? 	OTHER
What is a healthy body weight for a woman that is 5 feet 6 inches tall?	AMOUNT
What literature should 9th grade history students read?	OTHER
What are the health benefits of Vitamin E?	OTHER
How many different locations are there for the candle store "Wicks n' Sticks"?	AMOUNT
What is the yearly salary of a nurse anethesist?	MONEY
How long does it take to get a copyright in Canada?	DURATION
What is the title of Stephen King's latest book?	TITLE
What was Fred Flintstone's bowling nickname?	OTHER
How many numbers long is a phone number in Australia?	AMOUNT
How old will the actress Drew Barrymore be in 2015?	Y
What do I need to become an Australian citizen?	OTHER
What respiratory problems does dehydration cause? 	OTHER
What is the distance from Cologne to Solingen?	DISTANCE
What tribe of native american lived in the area where Whistler Mountain is located? 	OTHER
How much money does an elementary school teacher make per year?	MONEY
What is George Washington's middle name? 	OTHER
What is the migration pattern of Monarch butterflies? 	OTHER
How much should I pay for a head gasket auto repair?	MONEY
How do i get on Jeopardy? 	OTHER
What is the difference between a browser and a server?	OTHER
When were the first vehicle door latches made?	TIMEPOINT
What is a zamboni?	DESCRIPTION
How fast do Ethiopian chickens run?	AMOUNT
What percentage of homeless people are also mentally ill?	PERCENTAGE
How high is Mount Shasta?	DISTANCE
On the TV show "Petticoat Junction," what was the name of the dog on the show?	OTHER
What is considered average mileage on a 2 year old car? 	AMOUNT
When is the musical Rent playing in Reno, NV? 	TIMEPOINT
What was the first commercial use of computers? 	OTHER
How many people died in the Honduras mudslide?	AMOUNT
Who is the governor of Hawaii? 	PERSON
What was John F. Kennedy's yearly salary?	MONEY
What is the difference between APS film and 35mm film? 	OTHER
What was the name of the Air Base in Gosnell, Ark.? 	OTHER
What is a group of hippos called? 	OTHER
Name one example where geometry is found in nature.	OTHER
What is the most popular zoo in the United States?	OTHER
How many kosher restaurants are there in London?	AMOUNT
Where is West Point Military Academy?	LOCATION
Where can I find the best Dim Sum in Delaware?	LOCATION
When was ice cream invented?	TIMEPOINT
How many flavors of cotton candy are there?	AMOUNT
How does the National Endowment for the Arts recieve funding? 	OTHER
If I was born on April 7, what is my astrological sign?	OTHER
How do I kill a runaway process under HP-UX? 	OTHER
What herbs increase blood circulation? 	OTHER
What are transcedental numbers? 	DESCRIPTION
How many universities and colleges have a ceramics department?	AMOUNT
How many colleges offer summer programs for high school students?	AMOUNT
What are some of the causes of lower back pain? 	OTHER
How many words have the word "gum" in it?	AMOUNT
What month is the warmest in Florida?	OTHER
What are the most popular tourist attractions in Mt. Cook, New Zealand?	OTHER
What do you call a tent made of buffalo skins popularly used by the Indians of the Great Plains? 	OTHER
Who is Nick Seeley? 	DESCRIPTION
Who is the highest paid artist?	PERSON
How can I get rid of cat fleas in the house? 	OTHER
What is a herniated disk?	DESCRIPTION
What are the top three physics graduate schools? 	OTHER
How much would a week at Arrowhead Lodge on Table Rock Lake cost?	MONEY
Who was the last band or artist to perform at Woodstock?	OTHER
What is the average age of a cat?	Y
What is the legal way to settle a freight claim? 	OTHER
How many ballistic missiles are there in Russia and the United States?	AMOUNT
Who costars in Michael Keatons movie "Jack Frost"? 	PERSON
What is the anti-ballistic missile treaty? 	DESCRIPTION
How many different careers are there in the United States?	AMOUNT
Where is the best place to grow asparagus?	LOCATION
How do you remove scratches on glass windows?	OTHER
What country is the Technion Institute located in?	LOCATION
What program pyays .cda files? 	OTHER
How many marriages were performed in Maryland in 1967?	AMOUNT
How many children's accidental deaths could have been prevented with better home safety? 	AMOUNT
When was the first piece of grafitti spotted?	TIMEPOINT
What happens to your heart when you hiccup?	OTHER
Why are leaves green?	OTHER
Where is the best place to ski in Colorado?	LOCATION
What exercises are recommended to cure or relieve tendonitis in the elbow? 	OTHER
What is the difference between sweet potatoes and yams? 	OTHER
What is the historical significance of the Holy Land to the Jewish People? 	OTHER
What causes acne?	OTHER
What does Australia export to Laos? 	OTHER
What is dry ice?	DESCRIPTION
The city of Los Angeles was founded in what year?	TIMEPOINT
Who built the airplane called "Albatross"?	PERSON
Name an american actor that also produces.	PERSON
Who said: "The best defense is usually a good offense."	PERSON
What is the word for someone who hates men?	OTHER
How can I improve my eyesight?	OTHER
What is the name of the society for astronomers?	OTHER
What is the frequency response of Bose 301 loudspeakers?	AMOUNT
